# This file is generated see README.txt for details.

oun=!O!ung
nmn=!X\u221a\u2265\u221a\u00b5
alu='Are'are
kud='Auhelawa
hnh=//Ani
gnk=//Gana
xeg=//Xegwi
gwj=/Gwi
xam=/Xam
huc==/Hua
aue==/Kx'au//'ein
aot=A'tong
apq=A-Pucikwar
aiw=Aari
aas=Aas\u221a\u00b0x
kbt=Abadi
abg=Abaga
abf=Abai Sungai
abm=Abanyom
mij=Abar
aau=Abau
abq=Abaza
abp=Abenlen Ayta
abi=Abidji
bsa=Abinomn
axb=Abipon
ash=Abishira
ab=Abkhazian
abk=Abkhazian
aob=Abom
abo=Abon
abr=Abron
ado=Abu
aah=Abu' Arapesh
abn=Abua
abz=Abui
kgr=Abun
abu=Abure
mgj=Abureni
aba=Ab\u221a\u00a9
tpx=Acatepec Me'phaa
aca=Achagua
acn=Achang
yif=Ache
acz=Acheron
acr=Achi
ace=Achinese
act=Achterhoeks
acu=Achuar-Shiwiar
acv=Achumawi
guq=Ach\u221a\u00a9
ach=Acoli
acs=Acro\u221a\u00b0
adb=Adabe
xad=Adai
fub=Adamawa Fulfulde
ads=Adamorobe Sign Language
adn=Adang
adq=Adangbe
ada=Adangme
adp=Adap
tiu=Adasen
ade=Adele
adh=Adhola
adi=Adi
adj=Adioukrou
ort=Adivasi Oriya
gas=Adiwasi Garasia
adt=Adnyamathanha
adr=Adonara
adu=Aduge
ady=Adyghe
adz=Adzera
aez=Aeka
awi=Aekyom
xae=Aequian
aeq=Aer
aal=Afade
aa=Afar
aar=Afar
afg=Afghan Sign Language
aft=Afitti
afh=Afrihili
af=Afrikaans
afr=Afrikaans
afs=Afro-Seminole Creole
agd=Agarabi
agi=Agariya
agc=Agatu
avo=Agavotaguerra
agq=Aghem
ahh=Aghu
ggr=Aghu Tharnggalu
agx=Aghul
xag=Aghwan
aif=Agi
kit=Agob
ibm=Agoi
agu=Aguacateco
aga=Aguano
agr=Aguaruna
aug=Aguna
msm=Agusan Manobo
agn=Agutaynen
yay=Agwagwune
aha=Ahanta
thm=Aheu
ahr=Ahirani
aho=Ahom
aht=Ahtena
nfd=Ahwai
aih=Ai-Cham
aix=Aighon
tba=Aikan\u221a\u00a3
mwg=Aiklep
aiq=Aimaq
ail=Aimele
aim=Aimol
aic=Ainbai
aib=Ainu (China)
ain=Ainu (Japan)
aki=Aiome
air=Airoran
aio=Aiton
ajg=Aja (Benin)
aja=Aja (Sudan)
ajw=Ajawa
aji=Aji\u221a\u00b4
cpc=Ajy\u221a\u2260ninka Apurucayali
akq=Ak
soh=Aka
abj=Aka-Bea
akm=Aka-Bo
aci=Aka-Cari
akj=Aka-Jeru
akx=Aka-Kede
aky=Aka-Kol
ack=Aka-Kora
ak=Akan
aka=Akan
acl=Akar-Bale
aks=Akaselem
ake=Akawaio
aik=Ake
keu=Akebu
tsr=Akei
aeu=Akeu
ahk=Akha
akv=Akhvakh
akk=Akkadian
sia=Akkala Sami
akl=Aklanon
akt=Akolet
bss=Akoose
miw=Akoye
akf=Akpa
ibe=Akpes
afi=Akrukay
ayk=Akuku
aku=Akum
ako=Akurio
akw=Akwa
syy=Al-Sayyid Bedouin Sign Language
alw=Alaba-K\u201a\u00c4\u00f4abeena
akz=Alabama
dul=Alabat Island Agta
mim=Alacatlatzala Mixtec
ala=Alago
wbj=Alagwa
alk=Alak
amp=Alamblak
alj=Alangan
xln=Alanic
apv=Alapmunte
alh=Alawa
sq=Albanian
sqi=Albanian
bhk=Albay Bicolano
xta=Alcozauca Mixtec
alf=Alege
gah=Alekano
ale=Aleut
arq=Algerian Arabic
aao=Algerian Saharan Arabic
asp=Algerian Sign Language
alq=Algonquin
aiy=Ali
ald=Alladian
all=Allar
aid=Alngith
ypo=Alo Phola
aol=Alor
zaq=Alo\u221a\u00b0pam Zapotec
aes=Alsea
xua=Alu Kurumba
aub=Alugu
aab=Alumu-Tesu
alp=Alune
yna=Aluo
alz=Alur
alr=Alutor
avd=Alviri-Vidari
aly=Alyawarr
amm=Ama (Papua New Guinea)
nyi=Ama (Sudan)
amq=Amahai
amc=Amahuaca
ali=Amaimon
aad=Amal
amn=Amanab
ama=Amanay\u221a\u00a9
aie=Amara
amg=Amarag
amr=Amarakaeri
aaz=Amarasi
zpo=Amatl\u221a\u00b0n Zapotec
utp=Amba (Solomon Islands)
rwm=Amba (Uganda)
amk=Ambai
aew=Ambakich
abc=Ambala Ayta
amv=Ambelau
ael=Ambele
alm=Amblong
amb=Ambo
qva=Ambo-Pasco Quechua
abs=Ambonese Malay
aag=Ambrak
abt=Ambulas
amj=Amdang
adx=Amdo Tibetan
aey=Amele
ase=American Sign Language
ifa=Amganad Ifugao
am=Amharic
amh=Amharic
amy=Ami
ami=Amis
amo=Amo
alx=Amol
mbz=Amoltepec Mixtec
apg=Ampanang
ajz=Amri Karbi
amt=Amto
adw=Amundava
dti=Ana Tinga Dogon
anw=Anaang
akg=Anakalangu
anm=Anal
pda=Anam
aan=Anamb\u221a\u00a9
imi=Anamgura
bpo=Anasi
grc=Ancient Greek (to 1453)
hbo=Ancient Hebrew
xmk=Ancient Macedonian
xna=Ancient North Arabian
xzp=Ancient Zapotec
afd=Andai
xaa=Andalusian Arabic
hca=Andaman Creole Hindi
ana=Andaqui
aod=Andarum
adg=Andegerebinha
anr=Andh
ani=Andi
bzb=Andio
anb=Andoa
ano=Andoque
anx=Andra-Hus
aty=Aneityum
anz=Anem
aby=Aneme Wake
myo=Anfillo
agm=Angaataha
age=Angal
aoe=Angal Enen
akh=Angal Heneng
njm=Angami Naga
yli=Angguruk Yali
anp=Angika
xno=Anglo-Norman
rme=Angloromani
aoa=Angolar
agg=Angor
aog=Angoram
tnd=Angosturas Tunebo
ypn=Ani Phowa
blo=Anii
anf=Animere
aoi=Anindilyakwa
boj=Anjam
aak=Ankave
amx=Anmatyerre
anj=Anor
ans=Anserma
and=Ansus
ant=Antakarinya
xmv=Antankarana Malagasy
aig=Antigua and Barbuda Creole English
anl=Anu
anu=Anuak
cko=Anufo
aui=Anuki
auq=Anus
aud=Anuta
any=Anyin
mtb=Anyin Morofo
njo=Ao Naga
pni=Aoheng
aor=Aore
kbx=Ap Ma
xap=Apalachee
apy=Apala\u221a\u2260
ena=Apali
apo=Apalik
mip=Apasco-Apoala Mixtec
apt=Apatani
api=Apiak\u221a\u00b0
apn=Apinay\u221a\u00a9
app=Apma
ahp=Aproumu Aizi
apu=Apurin\u221a\u00a3
apx=Aputai
xaq=Aquitanian
ard=Arabana
arl=Arabela
ar=Arabic
ara=Arabic
an=Aragonese
arg=Aragonese
akr=Araki
atq=Aralle-Tabulahan
aam=Aramanik
stk=Arammba
aaf=Aranadan
xrt=Aranama-Tamique
jbj=Arandai
aro=Araona
arp=Arapaho
arj=Arapaso
arw=Arawak
awt=Arawet\u221a\u00a9
awm=Arawum
arv=Arbore
aae=Arb\u221a\u00b4resh\u221a\u00b4 Albanian
aqc=Archi
pka=Ardham\u0192\u00c5gadh\u0192\u00b4 Pr\u0192\u00c5krit
mwc=Are
aea=Areba
aem=Arem
qxu=Arequipa-La Uni\u221a\u2265n Quechua
aed=Argentine Sign Language
agj=Argobba
agf=Arguni
arh=Arhuaco
aqr=Arh\u221a\u00a2
aok=Arh\u221a\u2202
aac=Ari
laz=Aribwatsa
ylu=Aribwaung
aai=Arifama-Miniafia
aqg=Arigidi
ark=Arikap\u221a\u222b
ari=Arikara
ait=Arikem
xrn=Arin
luc=Aringa
aoh=Arma
xrm=Armazic
hy=Armenian
hye=Armenian
aen=Armenian Sign Language
apr=Arop-Lokep
aps=Arop-Sissano
aia=Arosi
atz=Arta
msy=Aruamu
aur=Aruek
lsr=Aruop
atx=Arutani
aru=Aru\u221a\u00b0 (Amazonas State)
arx=Aru\u221a\u00b0 (Rodonia State)
aat=Arvanitika Albanian
asz=As
mtv=Asaro'o
asd=Asas
ahs=Ashe
ask=Ashkun
csh=Asho Chin
atn=Ashtiani
cni=Ash\u221a\u00b0ninka
cjo=Ash\u221a\u00a9ninka Pajonal
prq=Ash\u221a\u00a9ninka Peren\u221a\u00a9
asl=Asilulu
eiv=Askopan
asv=Asoa
as=Assamese
asm=Assamese
xss=Assan
sjg=Assangori
asb=Assiniboine
aii=Assyrian Neo-Aramaic
ast=Asturian
aum=Asu (Nigeria)
asa=Asu (Tanzania)
psa=Asue Awyu
aua=Asumboa
zoo=Asunci\u221a\u2265n Mixtepec Zapotec
asr=Asuri
atm=Ata
atd=Ata Manobo
aqp=Atakapa
amz=Atampaya
mib=Atatl\u221a\u00b0huca Mixtec
tay=Atayal
ate=Atemble
aph=Athpariya
atk=Ati
atj=Atikamekw
aqm=Atohwaim
ato=Atong
aox=Atorada
atc=Atsahuaca
cch=Atsam
atw=Atsugewi
pkr=Attapady Kurumba
ati=Atti\u221a\u00a9
ocu=Atzingo Matlatzinca
avt=Au
djk=Aukan
aul=Aulua
aux=Aur\u221a\u00b0
auh=Aushi
avs=Aushiri
aut=Austral
asw=Australian Aborigines Sign Language
asf=Australian Sign Language
asq=Austrian Sign Language
smf=Auwe
auu=Auye
auo=Auyokawa
av=Avaric
ava=Avaric
avn=Avatime
avb=Avau
ae=Avestan
ave=Avestan
avi=Avikam
avu=Avokaya
avv=Av\u221a\u00b0-Canoeiro
vwa=Awa (China)
awb=Awa (Papua New Guinea)
kwi=Awa-Cuaiquer
awk=Awabakal
bcu=Awad Bing
awa=Awadhi
awo=Awak
aya=Awar
awx=Awara
awh=Awbono
bob=Aweer
awr=Awera
awe=Awet\u221a\u2260
azo=Awing
auy=Awiyaana
auj=Awjilah
awn=Awngi
kmn=Awtuw
yiu=Awu
aww=Awun
afu=Awutu
auw=Awyi
ahb=Axamb
yix=Axi Yi
ayd=Ayabadhu
quy=Ayacucho Quechua
vmy=Ayautla Mazatec
aye=Ayere
ayx=Ayi (China)
ayq=Ayi (Papua New Guinea)
nfl=Ayiwo
yyz=Ayizi
ayb=Ayizo Gbe
ay=Aymara
aym=Aymara
zaf=Ayoquesco Zapotec
ayo=Ayoreo
ayu=Ayu
miy=Ayutla Mixtec
az=Azerbaijani
aze=Azerbaijani
aza=Azha
yiz=Azhe
tpc=Azoy\u221a\u222b Me'phaa
bvj=Baan
bqx=Baangi
bba=Baatonum
bbw=Baba
mbf=Baba Malay
bbz=Babalia Creole Arabic
bbm=Babango
bbk=Babanki
baa=Babatana
bcr=Babine
bzg=Babuza
bcy=Bacama
btj=Bacanese Malay
xbc=Bactrian
bhz=Bada (Indonesia)
bau=Bada (Nigeria)
bfq=Badaga
bde=Bade
bdz=Badeshi
bia=Badimaya
bac=Badui
pbp=Badyara
bvd=Baeggu
bvc=Baelelea
btr=Baetora
bfj=Bafanji
bwt=Bafaw-Balong
ksf=Bafia
bfd=Bafut
bcg=Baga Binari
bqf=Baga Kaloum
bgo=Baga Koga
bmd=Baga Manduri
bgm=Baga Mboteni
bsp=Baga Sitemu
bsv=Baga Soban\u221a\u00a9
bfy=Bagheli
bmi=Bagirmi
fui=Bagirmi Fulfulde
bqg=Bago-Kusuntu
bgq=Bagri
bpi=Bagupi
bqb=Bagusa
kva=Bagvalal
yha=Baha Buyang
bdw=Baham
bah=Bahamas Creole English
abv=Baharna Arabic
bhv=Bahau
bjh=Bahinemo
bhj=Bahing
bdq=Bahnar
bsu=Bahonsuai
bdj=Bai
bbf=Baibai
bkx=Baikeno
bqh=Baima
bmx=Baimak
bcz=Bainouk-Gunyaamolo
bab=Bainouk-Gunyu\u221a\u00b1o
bcb=Bainouk-Samik
bsw=Baiso
fah=Baissa Fali
bjs=Bajan
bjm=Bajelani
bkc=Baka (Cameroon)
bdh=Baka (Sudan)
bkq=Bakair\u221a\u2260
bqz=Bakaka
bqi=Bakhtiari
bki=Baki
bkh=Bakoko
kme=Bakole
bbs=Bakpinka
bkr=Bakumpai
bjw=Bakw\u221a\u00a9
bls=Balaesang
blw=Balangao
sse=Balangingi
bjt=Balanta-Ganja
ble=Balanta-Kentohe
blz=Balantak
blg=Balau
bdn=Baldemu
bcp=Bali (Democratic Republic of Congo)
bcn=Bali (Nigeria)
ban=Balinese
mhp=Balinese Malay
bgx=Balkan Gagauz Turkish
rmn=Balkan Romani
bqo=Balo
biz=Baloi
bft=Balti
rml=Baltic Romani
blq=Baluan-Pam
bal=Baluchi
bog=Bamako Sign Language
bbq=Bamali
bmo=Bambalang
ptu=Bambam
bam=Bambara
bm=Bambara
myf=Bambassi
baw=Bambili-Bambui
bce=Bamenyam
bcf=Bamu
bqt=Bamukumbit
bax=Bamun
bvm=Bamunka
bmg=Bamwe
bfk=Ban Khor Sign Language
bcw=Bana
bjx=Banao Itneg
byz=Banaro
bnd=Banda (Indonesia)
bpq=Banda Malay
liy=Banda-Bambari
bpd=Banda-Banda
bqk=Banda-Mbr\u221a\u00aes
bfl=Banda-Nd\u221a\u00a9l\u221a\u00a9
yaj=Banda-Yangere
bza=Bandi
bqj=Bandial
bdy=Bandjalang
bjd=Bandjigali
bxg=Bangala
bgf=Bangandu
bbe=Bangba
bgz=Banggai
bjb=Banggarla
bni=Bangi
dba=Bangi Me
mfb=Bangka
bgj=Bangolan
bnx=Bangubangu
bsj=Bangwinji
bvv=Baniva
bwi=Baniwa
bjn=Banjar
bxw=Bankagooma
abb=Bankon
bcm=Bannoni
bap=Bantawa
bnq=Bantik
bno=Bantoanon
bci=Baoul\u221a\u00a9
bhr=Bara Malagasy
brd=Baraamu
bbb=Barai
baj=Barakai
kys=Baram Kayan
bbg=Barama
brm=Barambu
bmz=Baramu
brp=Barapasi
brs=Baras
bsn=Barasana-Eduria
bpb=Barbacoas
boi=Barbare\u221a\u00b1o
gry=Barclayville Grebo
bcj=Bardi
bva=Barein
mlp=Bargam
bfa=Bari
bch=Bariai
bjc=Bariji
bxo=Barikanchi
bjk=Barok
bbi=Barombi
tbn=Barro Negro Tunebo
bpt=Barrow Point
bjz=Baruga
byr=Baruya
bwg=Barwe
bjf=Barzani Jewish Neo-Aramaic
bae=Bar\u221a\u00a9
mot=Bar\u221a\u2260
bas=Basa (Cameroon)
bzw=Basa (Nigeria)
bsl=Basa-Gumna
buj=Basa-Gurmana
bdb=Basap
byq=Basay
bsg=Bashkardi
ba=Bashkir
bak=Bashkir
bst=Basketo
eu=Basque
eus=Basque
bsq=Bassa
bsr=Bassa-Kontagora
bsc=Bassari
bsi=Bassossi
bta=Bata
ayt=Bataan Ayta
ifb=Batad Ifugao
bya=Batak
btz=Batak Alas-Kluet
akb=Batak Angkola
btd=Batak Dairi
btx=Batak Karo
btm=Batak Mandailing
bts=Batak Simalungun
bbc=Batak Toba
bnm=Batanga
btq=Batek
btv=Bateri
bhm=Bathari
btc=Bati (Cameroon)
bvt=Bati (Indonesia)
bbl=Bats
btu=Batu
zbt=Batui
bay=Batuley
bbd=Bau
sne=Bau Bidayuh
bsf=Bauchi
brg=Baure
bge=Bauria
bxa=Bauro
bwk=Bauwaki
bvz=Bauzi
bar=Bavarian
bgr=Bawm Chin
mkq=Bay Miwok
bjy=Bayali
byg=Baygo
byl=Bayono
bda=Bayot
bxj=Bayungu
bfr=Bazigar
beo=Beami
bea=Beaver
bfp=Beba
bzv=Bebe
beb=Bebele
bek=Bebeli
bxp=Bebil
tnr=Bedik
bjv=Bedjond
bed=Bedoanas
bkf=Beeke
bxq=Beele
beq=Beembe
bnz=Beezen
bby=Befang
bqv=Begbere-Ejar
bej=Beja
bei=Bekati'
bkv=Bekwarra
bkw=Bekwil
beg=Belait
bxb=Belanda Bor
bvi=Belanda Viri
be=Belarusian
bel=Belarusian
byw=Belhariya
bey=Beli (Papua New Guinea)
blm=Beli (Sudan)
bzj=Belize Kriol English
blc=Bella Coola
brw=Bellari
bmy=Bemba (Democratic Republic of Congo)
bem=Bemba (Zambia)
bmb=Bembe
yun=Bena (Nigeria)
bez=Bena (Tanzania)
bef=Benabena
bcq=Bench
bdp=Bende
bct=Bendi
nhb=Beng
bng=Benga
ben=Bengali
bn=Bengali
bgy=Benggoi
bqy=Bengkala Sign Language
bnu=Bentong
byd=Benyadu'
bue=Beothuk
bie=Bepour
brf=Bera
bxv=Berakou
bve=Berau Malay
brc=Berbice Creole Dutch
bkl=Berik
bit=Berinomo
bom=Berom
wti=Berta
byt=Berti
mhe=Besisi
bes=Besme
bep=Besoa
bfe=Betaf
bew=Betawi
byf=Bete
btt=Bete-Bendi
btb=Beti (Cameroon)
eot=Beti (C\u221a\u00a5te d'Ivoire)
xub=Betta Kurumba
kap=Bezhta
bhd=Bhadrawahi
bhx=Bhalay
bha=Bharia
btl=Bhatola
bgw=Bhatri
bht=Bhattiyali
bhe=Bhaya
bhy=Bhele
bhi=Bhilali
bhb=Bhili
bho=Bhojpuri
nes=Bhoti Kinnauri
bhu=Bhunjia
bif=Biafada
bhw=Biak
beh=Biali
bpv=Bian Marind
big=Biangai
byk=Biao
bmt=Biao Mon
bje=Biao-Jiao Mien
bth=Biatah Bidayuh
bid=Bidiyo
bym=Bidyara
bjg=Bidyogo
bmc=Biem
bnk=Bierebo
brj=Bieria
biu=Biete
nmb=Big Nambas
bhc=Biga
bix=Bijori
bic=Bikaru
bik=Bikol
byb=Bikya
bip=Bila
bql=Bilakura
kfs=Bilaspuri
bpz=Bilba
brz=Bilbil
bil=Bile
byn=Bilin
bms=Bilma Kanuri
bll=Biloxi
blb=Bilua
bxf=Bilur
bhp=Bima
bhl=Bimin
bim=Bimoba
byj=Bina (Nigeria)
bmn=Bina (Papua New Guinea)
bxz=Binahari
bhg=Binandere
bon=Bine
bin=Bini
bpj=Binji
itb=Binongan Itneg
bne=Bintauna
bny=Bintulu
bkd=Binukid
bjr=Binumarien
biq=Bipi
bxe=Birale
brr=Birao
btf=Birgit
biy=Birhor
bzr=Biri
bqq=Biritai
brk=Birked
bvq=Birri
brl=Birwa
ije=Biseni
bpy=Bishnupriya
bwh=Bishuo
bnw=Bisis
bi=Bislama
bis=Bislama
bir=Bisorio
bib=Bissa
bzi=Bisu
bgk=Bit
brt=Bitare
mcc=Bitur
bwm=Biwat
byo=Biyo
bpm=Biyom
blp=Blablanga
bfh=Blafe
beu=Blagar
blr=Blang
zbl=Blissymbols
bgl=Bo (Laos)
bpw=Bo (Papua New Guinea)
mae=Bo-Rukul
mux=Bo-Ung
bzn=Boano (Maluku)
bzl=Boano (Sulawesi)
bgb=Bobongko
bty=Bobot
boy=Bodo (Central African Republic)
brx=Bodo (India)
gbj=Bodo Gadaba
bdv=Bodo Parja
bff=Bofi
bvw=Boga
boq=Bogaya
bux=Boghom
bqu=Boguru
bhn=Bohtan Neo-Aramaic
bzf=Boikin
ybk=Bokha
bqc=Boko (Benin)
bkp=Boko (Democratic Republic of Congo)
bus=Bokobaru
bdt=Bokoto
bky=Bokyi
bnp=Bola
bld=Bolango
bol=Bole
xbo=Bolgarian
bvo=Bolgo
bli=Bolia
smk=Bolinao
bvl=Bolivian Sign Language
blv=Bolo
bkt=Boloki
bof=Bolon
bzm=Bolondo
blj=Bolongan
ply=Bolyu
bmf=Bom
boh=Boma
bml=Bomboli
bws=Bomboma
zmx=Bomitaba
bmq=Bomu
bmw=Bomwali
glc=Bon Gula
peh=Bonan
bou=Bondei
bfw=Bondo
kzc=Bondoukou Kulango
dbu=Bondum Dom Dogon
bna=Bonerate
bnv=Bonerif
bdg=Bonggi
bpg=Bonggo
bui=Bongili
bot=Bongo
bpu=Bongu
bok=Bonjo
bvg=Bonkeng
bop=Bonkiman
bnb=Bookan
bnl=Boon
bvf=Boor
boa=Bora
gax=Borana-Arsi-Guji Oromo
kvn=Border Kuna
gai=Borei
fue=Borgu Fulfulde
bxx=Borna (Democratic Republic of Congo)
bwo=Boro (Ethiopia)
xxb=Boro (Ghana)
ksr=Borong
brn=Boruca
bor=Bor\u221a\u00a5ro
bwf=Boselewa
bqs=Bosngun
bos=Bosnian
bs=Bosnian
bmj=Bote-Majhi
bph=Botlikh
sbl=Botolan Sambal
nku=Bouna Kulango
pcc=Bouyei
bzo=Bozaba
aof=Bragat
brh=Brahui
bra=Braj
bzs=Brazilian Sign Language
kvl=Brek Karen
buq=Brem
brq=Breri
br=Breton
bre=Breton
bzd=Bribri
bzt=Brithenig
bfi=British Sign Language
bro=Brokkat
sgt=Brokpake
bkk=Brokskat
plw=Brooke's Point Palawano
bpl=Broome Pearling Lugger Pidgin
kxd=Brunei
bsb=Brunei Bisaya
jid=Bu
bwx=Bu-Nao Bunu
bub=Bua
cbl=Bualkhaw Chin
box=Buamu
bvb=Bube
buw=Bubi
bbx=Bubia
stt=Budeh Stieng
btp=Budibud
bdx=Budong-Budong
buu=Budu
bdk=Budukh
bdm=Buduma
bja=Budza
bbh=Bugan
buk=Bugawac
bgt=Bughotu
bug=Buginese
sab=Buglere
bgg=Bugun
bku=Buhid
bxh=Buhutu
byh=Bujhyal
sdo=Bukar-Sadung Bidayuh
bvk=Bukat
bhh=Bukharic
bvu=Bukit Malay
bkn=Bukitan
ape=Bukiyip
tkb=Buksa
bxk=Bukusu
buz=Bukwen
bg=Bulgarian
bul=Bulgarian
bqn=Bulgarian Sign Language
bmp=Bulgebi
bwu=Buli (Ghana)
bzq=Buli (Indonesia)
buy=Bullom So
sti=Bulo Stieng
bum=Bulu (Cameroon)
bjl=Bulu (Papua New Guinea)
bmv=Bum
byp=Bumaji
aon=Bumbita Arapesh
kjz=Bumthangkha
buv=Bun
bvn=Buna
bck=Bunaba
bfn=Bunak
bdd=Bunama
bns=Bundeli
bqd=Bung
but=Bungain
bkz=Bungku
wun=Bungu
dgb=Bunoge Dogon
bnn=Bunun
blf=Buol
bwr=Bura-Pabir
bys=Burak
bkg=Buraka
bvr=Burarra
bti=Burate
bxn=Burduna
bvh=Bure
bua=Buriat
bji=Burji
vrt=Burmbar
my=Burmese
mya=Burmese
bzu=Burmeso
mhs=Buru (Indonesia)
bqw=Buru (Nigeria)
bry=Burui
bmu=Burum-Mindik
aip=Burumakok
bdi=Burun
bds=Burunge
bsk=Burushaski
bqr=Burusu
asi=Buruwai
bqp=Busa
bxs=Busam
bsm=Busami
bfg=Busang Kayan
buc=Bushi
buf=Bushoong
bso=Buso
bup=Busoa
dox=Bussa
bju=Busuu
kyb=Butbut Kalinga
bnr=Butmas-Tur
btw=Butuanon
bhs=Buwal
byy=Buya
byi=Buyu
jiy=Buyuan Jinuo
bww=Bwa
bwd=Bwaidoka
tte=Bwanabwana
bwa=Bwatoo
bwe=Bwe Karen
bwl=Bwela
bwc=Bwile
bwz=Bwisi
bee=Byangsi
mkk=Byep
khd=B\u221a\u00a7di Kanum
dri=C'lela
msq=Caac
cbb=Cabiyar\u221a\u2260
cjp=Cab\u221a\u00a9car
miu=Cacaloxtepec Mixtec
ccr=Cacaopera
roc=Cacgia Roglai
cbv=Cacua
cad=Caddo
ccd=Cafundo Creole
cbh=Cagua
cah=Cahuarano
chl=Cahuilla
qvc=Cajamarca Quechua
qvl=Cajatambo North Lima Quechua
zad=Cajonos Zapotec
frc=Cajun French
ckx=Caka
ckz=Cakchiquel-Quich\u221a\u00a9 Mixed Language
cky=Cakfem-Mushere
tbk=Calamian Tagbanwa
qud=Calder\u221a\u2265n Highland Quichua
caw=Callawalla
clu=Caluyanun
rmr=Cal\u221a\u2265
abd=Camarines Norte Agta
mcu=Cameroon Mambila
wes=Cameroon Pidgin
rab=Camling
cml=Campalagian
sro=Campidanese Sardinian
kbh=Cams\u221a\u00b0
cmt=Camtho
xcc=Camunic
cbu=Candoshi-Shapra
ram=Canela
caz=Canichana
mlc=Cao Lan
cov=Cao Miao
kaq=Capanahua
cps=Capiznon
cpg=Cappadocian Greek
cot=Caquinte
caq=Car Nicobarese
cfd=Cara
cby=Carabayo
crf=Caramanta
cbc=Carapana
xcr=Carian
hns=Caribbean Hindustani
jvn=Caribbean Javanese
cbd=Carijona
crr=Carolina Algonquian
cal=Carolinian
rmc=Carpathian Romani
crx=Carrier
cbr=Cashibo-Cacataibo
cbs=Cashinahua
dgc=Casiguran Dumagat Agta
asc=Casuarina Coast Asmat
mst=Cataelano Mandaya
ca=Catalan
cat=Catalan
csc=Catalan Sign Language
chc=Catawba
cca=Cauca
cav=Cavine\u221a\u00b1a
cyb=Cayubaba
cay=Cayuga
xcy=Cayuse
qxr=Ca\u221a\u00b1ar Highland Quichua
sef=Cebaara Senoufo
ceb=Cebuano
xce=Celtiberian
cam=Cemuh\u221a\u00c6
cen=Cen
cns=Central Asmat
tzm=Central Atlas Tamazight
awu=Central Awyu
ayr=Central Aymara
bca=Central Bai
zbc=Central Berawan
bcl=Central Bicolano
bnc=Central Bontoc
agt=Central Cagayan Agta
dtp=Central Dusun
grv=Central Grebo
zch=Central Hongshuihe Zhuang
nch=Central Huasteca Nahuatl
hmc=Central Huishui Hmong
knc=Central Kanuri
khm=Central Khmer
km=Central Khmer
ckb=Central Kurdish
mwo=Central Maewo
pse=Central Malay
mxz=Central Masela
hmm=Central Mashan Hmong
maz=Central Mazahua
mel=Central Melanau
cmo=Central Mnong
nhn=Central Nahuatl
ncb=Central Nicobarese
ojc=Central Ojibwa
ryu=Central Okinawan
plc=Central Palawano
pbs=Central Pame
pst=Central Pashto
poo=Central Pomo
ncx=Central Puebla Nahuatl
sml=Central Sama
ess=Central Siberian Yupik
csm=Central Sierra Miwok
syb=Central Subanen
tgt=Central Tagbanwa
tar=Central Tarahumara
tuf=Central Tunebo
esu=Central Yupik
fuq=Central-Eastern Niger Fulfulde
cet=Cent\u221a\u222b\u221a\u222bm
cme=Cerma
quk=Chachapoyas Quechua
cbi=Chachi
shu=Chadian Arabic
cds=Chadian Sign Language
cdy=Chadong
chg=Chagatai
ciy=Chaima
ckh=Chak
cli=Chakali
ccp=Chakma
cll=Chala
cld=Chaldean Neo-Aramaic
tgf=Chalikha
ceg=Chamacoco
cji=Chamalal
cdg=Chamari
cdh=Chambeali
can=Chambri
ccc=Chamicuro
ch=Chamorro
cha=Chamorro
nbc=Chang Naga
cga=Changriwa
cna=Changthang
chx=Chantyal
caj=Chan\u221a\u00a9
cra=Chara
cdn=Chaudangsi
ccq=Chaungtha
crv=Chaura
cbk=Chavacano
cbt=Chayahuita
mih=Chayuco Mixtec
xtb=Chazumba Mixtec
ruk=Che
ce=Chechen
che=Chechen
mrn=Cheke Holo
xch=Chemakum
cjn=Chenapian
cde=Chenchu
cnu=Chenoua
cdm=Chepang
ycp=Chepya
cpn=Cherepon
chr=Cherokee
ych=Chesu
ctc=Chetco
cwg=Chewong
chy=Cheyenne
hne=Chhattisgarhi
ctn=Chhintange
cur=Chhulung
csd=Chiangmai Sign Language
cip=Chiapanec
chb=Chibcha
trs=Chicahuaxtla Triqui
zpv=Chichicapan Zapotec
pei=Chichimeca-Jonaz
cic=Chickasaw
cob=Chicomuceltec
cgg=Chiga
mii=Chigmecatitl\u221a\u00b0n Mixtec
clc=Chilcotin
cqu=Chilean Quechua
csg=Chilean Sign Language
clh=Chilisso
csa=Chiltepec Chinantec
cmk=Chimakum
zoh=Chimalapa Zoque
cid=Chimariko
qug=Chimborazo Highland Quichua
cbg=Chimila
bxu=China Buriat
cih=Chinali
cnb=Chinbon Chin
qxc=Chincha Quechua
zh=Chinese
zho=Chinese
cpi=Chinese Pidgin English
csl=Chinese Sign Language
chh=Chinook
chn=Chinook jargon
cap=Chipaya
chp=Chipewyan
cbe=Chipiajes
ciw=Chippewa
maq=Chiquihuitl\u221a\u00b0n Mazatec
cax=Chiquitano
qxa=Chiqui\u221a\u00b0n Ancash Quechua
nhd=Chirip\u221a\u00b0
cdf=Chiru
ctm=Chitimacha
cik=Chitkuli Kinnauri
ctg=Chittagonian
the=Chitwania Tharu
zpc=Choapan Zapotec
cgk=Chocangacakha
coz=Chochotec
cho=Choctaw
cdi=Chodri
nri=Chokri Naga
cjk=Chokwe
ctu=Chol
cht=Chol\u221a\u2265n
cog=Chong
cda=Choni
coh=Chonyi-Dzihana-Kauma
cce=Chopi
xco=Chorasmian
cjr=Chorotega
caa=Chort\u221a\u2260
nct=Chothe Naga
crw=Chrau
cje=Chru
cqd=Chuanqiandian Cluster Miao
cjv=Chuave
cvg=Chug
cac=Chuj
cuh=Chuka
ckt=Chukot
cuw=Chukwa
clw=Chulym
ncu=Chumburung
cdj=Churahi
chu=Church Slavic
cu=Church Slavic
scb=Chut
chk=Chuukese
xcv=Chuvantsy
chv=Chuvash
cv=Chuvash
chw=Chuwabu
cao=Ch\u221a\u00b0cobo
cib=Ci Gbe
cia=Cia-Cia
ckl=Cibak
awc=Cicipu
cim=Cimbrian
mkx=Cinamiguin Manobo
cdr=Cinda-Regi-Tiyal
cie=Cineni
cin=Cinta Larga
xcg=Cisalpine Gaulish
asg=Cishingini
txt=Citak
tgd=Ciwogai
clm=Clallam
xcl=Classical Armenian
myz=Classical Mandaic
cmg=Classical Mongolian
nci=Classical Nahuatl
nwc=Classical Newari
qwc=Classical Quechua
syc=Classical Syriac
xct=Classical Tibetan
xcw=Coahuilteco
csi=Coast Miwok
kzj=Coastal Kadazan
kjc=Coastal Konjo
zca=Coatecas Altas Zapotec
naz=Coatepec Nahuatl
mco=Coatl\u221a\u00b0n Mixe
zps=Coatl\u221a\u00b0n Zapotec
miz=Coatzospan Mixtec
cod=Cocama-Cocamilla
coj=Cochimi
coc=Cocopa
coa=Cocos Islands Malay
crd=Coeur d'Alene
con=Cof\u221a\u00b0n
kog=Cogui
liw=Col
csn=Colombian Sign Language
gct=Colonia Tovar German
cof=Colorado
col=Columbia-Wenatchi
cco=Comaltepec Chinantec
com=Comanche
xcm=Comecrudo
cfg=Como Karim
coo=Comox
cno=Con
swc=Congo Swahili
csz=Coos
zoc=Copainal\u221a\u00b0 Zoque
trc=Copala Triqui
cop=Coptic
coq=Coquille
cry=Cori
cor=Cornish
kw=Cornish
qwa=Corongo Ancash Quechua
co=Corsican
cos=Corsican
csr=Costa Rican Sign Language
mta=Cotabato Manobo
xcn=Cotoname
cow=Cowlitz
kox=Coxima
coy=Coyaima
pbf=Coyotepec Popoloca
toc=Coyutla Totonac
cr=Cree
cre=Cree
mus=Creek
crh=Crimean Tatar
csq=Croatia Sign Language
hr=Croatian
hrv=Croatian
mfn=Cross River Mbembe
cro=Crow
crz=Cruze\u221a\u00b1o
cua=Cua
csf=Cuba Sign Language
cub=Cubeo
cui=Cuiba
cul=Culina
cuo=Cumanagoto
xcb=Cumbric
cum=Cumeral
cuq=Cun
xlu=Cuneiform Luwian
cug=Cung
cup=Cupe\u221a\u00b1o
xcu=Curonian
kpc=Curripaco
quz=Cusco Quechua
ccl=Cutchi-Swahili
cuv=Cuvok
xtu=Cuyamecalco Mixtec
cyo=Cuyonon
bwy=Cwi Bwamu
acy=Cypriot Arabic
ces=Czech
cs=Czech
cse=Czech Sign Language
cnc=C\u221a\u00a5\u221a\u00a5ng
kzf=Da'a Kaili
dao=Daai Chin
lni=Daantanai'
dsh=Daasanach
dbq=Daba
dbr=Dabarre
dbe=Dabe
xdc=Dacian
mps=Dadibi
dbd=Dadiya
dgz=Daga
dgd=Dagaari Dioula
dgk=Dagba
dag=Dagbani
dec=Dagik
dgn=Dagoman
dal=Dahalo
das=Daho-Doo
dij=Dai
zhd=Dai Zhuang
drb=Dair
bpa=Dakaka
dkk=Dakka
dak=Dakota
dka=Dakpakha
dlm=Dalmatian
bev=Daloa B\u221a\u00a9t\u221a\u00a9
dmm=Dama
dam=Damakawa
uhn=Damal
dac=Dambi
dml=Dameli
dms=Dampelas
daf=Dan
dnr=Danaru
dnu=Danau
daq=Dandami Maria
daa=Dangal\u221a\u00a9at
thl=Dangaura Tharu
da=Danish
dan=Danish
dsl=Danish Sign Language
aso=Dano
daz=Dao
dnd=Daonda
djc=Dar Daju Daju
daj=Dar Fur Daju
dau=Dar Sila Daju
dry=Darai
dar=Dargwa
prs=Dari
drh=Darkhat
drl=Darling
dln=Darlong
drd=Darmiya
dro=Daro-Matu Melanau
drw=Darwazi
dot=Dass
tcc=Datooga
dta=Daur
daw=Davawenyo
dww=Dawawa
ddw=Dawera-Daweloor
dwr=Dawro
dai=Day
dax=Dayi
dzd=Daza
dzg=Dazaga
dcc=Deccan
ded=Dedua
afn=Defaka
gbh=Defi Gbe
mzw=Deg
dgu=Degaru
deg=Degema
dge=Degenan
ing=Degexit'an
dhv=Dehu
deh=Dehwari
dek=Dek
row=Dela-Oenale
del=Delaware
ntr=Delo
dem=Dem
dmx=Dema
dei=Demisa
dmy=Demta
ddn=Dendi (Benin)
deq=Dendi (Central African Republic)
dez=Dengese
dnk=Dengka
dbb=Deno
anv=Denya
dny=Den\u221a\u2260
der=Deori
kbv=Dera (Indonesia)
kna=Dera (Nigeria)
des=Desano
dso=Desiya
dee=Dewoin
def=Dezfuli
dgh=Dghwede
dhs=Dhaiso
dhl=Dhalandji
dhg=Dhangu
dhn=Dhanki
dha=Dhanwar (India)
dhw=Dhanwar (Nepal)
nfa=Dhao
dhr=Dhargari
mki=Dhatki
dhi=Dhimal
div=Dhivehi
dv=Dhivehi
dho=Dhodia
adf=Dhofari Arabic
dhd=Dhundari
dhu=Dhurga
duj=Dhuwal
dia=Dia
mbd=Dibabawon Manobo
dby=Dibiyaso
dio=Dibo
bvx=Dibole
duy=Dicamay Agta
did=Didinga
ddo=Dido
dif=Dieri
mhu=Digaro-Mishmi
dig=Digo
dur=Dii
cfa=Dijim-Bwilim
dil=Dilling
jma=Dima
dis=Dimasa
dii=Dimbong
dim=Dime
dmc=Dimir
diq=Dimli (individual language)
diz=Ding
din=Dinka
ddi=Diodio
dit=Dirari
gdl=Dirasha
dwa=Diri
diu=Diriku
dir=Dirim
dsi=Disa
tbz=Ditammari
diy=Diuwe
xtd=Diuxi-Tilantongo Mixtec
dix=Dixon Reef
mdx=Dizin
djr=Djambarrpuyngu
djd=Djamindjung
djf=Djangun
djn=Djauan
djw=Djawi
djj=Djeebbana
dyi=Djimini Senoufo
dji=Djinang
djb=Djinba
jig=Djingili
djl=Djiwarli
kvo=Dobel
dob=Dobu
doe=Doe
dgg=Doga
dgx=Doghoro
dgs=Dogoso
dos=Dogos\u221a\u00a9
dgo=Dogri (individual language)
doi=Dogri (macrolanguage)
dgr=Dogrib
dbg=Dogul Dom Dogon
dbi=Doka
uya=Doko-Uyanga
dlg=Dolgan
dre=Dolpo
doa=Dom
dmk=Domaaki
rmt=Domari
dov=Dombe
doq=Dominican Sign Language
doy=Dompo
dof=Domu
dev=Domung
dok=Dondo
doh=Dong
doo=Dongo
ddd=Dongotono
yik=Dongshanba Lalo
sce=Dongxiang
dds=Donno So Dogon
dde=Doondo
dor=Dori'o
kqc=Doromu-Koki
drr=Dororo
doz=Dorze
dol=Doso
tds=Doutai
dow=Doyayo
drt=Drents
duu=Drung
dua=Duala
dup=Duano
dva=Duau
dub=Dubli
dmu=Dubu
duk=Duduela
ndu=Dugun
dbm=Duguri
dme=Dugwor
kbz=Duhwa
nke=Duke
dbo=Dulbu
duz=Duli
dma=Duma
duf=Dumbea
dus=Dumi
dmv=Dumpas
wtf=Dumpu
dui=Dumun
duc=Duna
dng=Dungan
raa=Dungmali
duh=Dungra Bhil
dbv=Dungu
duo=Dupaninan Agta
drq=Dura
nln=Durango Nahuatl
mvp=Duri
dbn=Duriankere
dug=Duruma
pci=Duruwa
dsn=Dusner
dun=Dusun Deyah
duq=Dusun Malang
duw=Dusun Witu
nl=Dutch
nld=Dutch
dse=Dutch Sign Language
dws=Dutton World Speedwords
dux=Duungooma
dae=Duupa
duv=Duvle
dbp=Duwai
gve=Duwet
nnu=Dwang
dyy=Dyaabugay
dyb=Dyaberdyaber
dya=Dyan
dyn=Dyangadi
dbl=Dyirbal
dyd=Dyugun
dyu=Dyula
jen=Dza
dzl=Dzalakha
dzn=Dzando
bpn=Dzao Min
add=Dzodinka
dz=Dzongkha
dzo=Dzongkha
dnn=Dz\u221a\u03c0\u221a\u03c0ngoo
kwa=D\u221a\u00a2w
eee=E
yzg=E'ma Buyang
pbh=E'\u221a\u00b1apa Woromaipu
xtr=Early Tripuri
omb=East Ambae
zbe=East Berawan
dmr=East Damar
fud=East Futuna
kjs=East Kewa
lma=East Limba
mky=East Makian
vme=East Masela
nle=East Nyala
tre=East Tarangan
yuy=East Yugur
aaq=Eastern Abnaki
acp=Eastern Acipa
qve=Eastern Apur\u221a\u2260mac Quechua
aer=Eastern Arrernte
bgp=Eastern Balochi
gui=Eastern Bolivian Guaran\u221a\u2260
bru=Eastern Bru
ike=Eastern Canadian Inuktitut
cjm=Eastern Cham
avl=Eastern Egyptian Bedawi Arabic
frs=Eastern Frisian
tge=Eastern Gorkha Tamang
ggn=Eastern Gurung
cly=Eastern Highland Chatino
otm=Eastern Highland Otomi
zeh=Eastern Hongshuihe Zhuang
nhe=Eastern Huasteca Nahuatl
hme=Eastern Huishui Hmong
xrb=Eastern Karaboro
ktv=Eastern Katu
eky=Eastern Kayah
kee=Eastern Keres
kqo=Eastern Krahn
yit=Eastern Lalu
lwl=Eastern Lawa
mgp=Eastern Magar
emk=Eastern Maninkakan
mhr=Eastern Mari
emg=Eastern Meohang
mng=Eastern Mnong
emu=Eastern Muria
nea=Eastern Ngad'a
nos=Eastern Nisu
ojg=Eastern Ojibwa
hae=Eastern Oromo
kif=Eastern Parbate Kham
pez=Eastern Penan
peb=Eastern Pomo
hmq=Eastern Qiandong Miao
taj=Eastern Tamang
bnj=Eastern Tawbuid
muq=Eastern Xiangxi Miao
gbx=Eastern Xwla Gbe
ydd=Eastern Yiddish
igb=Ebira
xeb=Eblan
ebr=Ebri\u221a\u00a9
ebg=Ebughu
ecs=Ecuadorian Sign Language
cbj=Ede Cabe
ica=Ede Ica
idd=Ede Idaca
ijj=Ede Ije
nqg=Ede Nago
awy=Edera Awyu
etr=Edolo
xdm=Edomite
dbf=Edopi
efa=Efai
efe=Efe
efi=Efik
ofu=Efutop
ega=Ega
ego=Eggon
esl=Egypt Sign Language
egy=Egyptian (Ancient)
arz=Egyptian Arabic
ehu=Ehueun
eip=Eipomek
eit=Eitiep
etu=Ejagham
eja=Ejamat
eka=Ekajuk
ekg=Ekari
eki=Eki
eke=Ekit
ekp=Ekpeye
zpp=El Alto Zapotec
elh=El Hugeirat
elo=El Molo
crn=El Nayar Cora
elx=Elamite
elm=Eleme
ele=Elepi
ekm=Elip
elk=Elkei
zte=Elotepec Zapotec
afo=Eloyi
elp=Elpaputih
mrf=Elseng
elu=Elu
xly=Elymian
mmw=Emae
ema=Emai-Iuleha-Ora
emn=Eman
emb=Embaloh
bdc=Ember\u221a\u00b0-Baud\u221a\u2265
cto=Ember\u221a\u00b0-Cat\u221a\u2260o
cmi=Ember\u221a\u00b0-Cham\u221a\u2260
tdc=Ember\u221a\u00b0-Tad\u221a\u2265
ebu=Embu
eme=Emerillon
egl=Emilian
emo=Emok
emw=Emplawas
enr=Emumu
enc=En
unk=Enawen\u221a\u00a9-Naw\u221a\u00a9
end=Ende
enq=Enga
enn=Engenni
eno=Enggano
en=English
eng=English
ptt=Enrekang
enu=Enu
enw=Enwan (Akwa Ibom State)
env=Enwan (Edu State)
gey=Enya
sja=Epena
xep=Epi-Olmec
epi=Epie
emy=Epigraphic Mayan
era=Eravallan
kjy=Erave
twp=Ere
ert=Eritai
erw=Erokwanas
err=Erre
ers=Ersu
erh=Eruwa
myv=Erzya
ish=Esan
mcq=Ese
ese=Ese Ejja
esh=Eshtehardi
ags=Esimbi
eo=Esperanto
epo=Esperanto
esq=Esselen
ots=Estado de M\u221a\u00a9xico Otomi
est=Estonian
et=Estonian
eso=Estonian Sign Language
esm=Esuma
etc=Etchemin
etb=Etebi
etx=Eten
ecr=Eteocretan
ecy=Eteocypriot
eth=Ethiopian Sign Language
ich=Etkywan
eto=Eton (Cameroon)
etn=Eton (Vanuatu)
ett=Etruscan
utr=Etulo
bzz=Evant
eve=Even
evn=Evenki
nou=Ewage-Notu
ee=Ewe
ewe=Ewe
ewo=Ewondo
ext=Extremaduran
eya=Eyak
fab=Fa D'ambu
faf=Fagani
azt=Faire Atta
faj=Faita
fai=Faiwol
fax=Fala
cfm=Falam Chin
fli=Fali
xfa=Faliscan
fam=Fam
fng=Fanagalo
fak=Fang (Cameroon)
fan=Fang (Equatorial Guinea)
fni=Fania
fat=Fanti
fmu=Far Western Muria
gur=Farefare
fao=Faroese
fo=Faroese
fqs=Fas
faa=Fasu
far=Fataleka
ddg=Fataluku
fau=Fayu
fmp=Fe'fe'
agl=Fembe
fpe=Fernando Po Creole English
fer=Feroge
hif=Fiji Hindi
fij=Fijian
fj=Fijian
fil=Filipino
tlp=Filomena Mata-Coahuitl\u221a\u00b0n Totonac
bkb=Finallig
fss=Finland-Swedish Sign Language
fi=Finnish
fin=Finnish
fse=Finnish Sign Language
fag=Finongan
fip=Fipa
fir=Firan
fiw=Fiwaga
fln=Flinders Island
flh=Foau
foi=Foi
ffi=Foia Foia
ppo=Folopa
fom=Foma
fon=Fon
fgr=Fongoro
fod=Foodo
frq=Forak
frd=Fordata
for=Fore
enf=Forest Enets
myq=Forest Maninka
frt=Fortsenal
zos=Francisco Le\u221a\u2265n Zoque
frp=Franco-Proven\u221a\u00dfal
frk=Frankish
fr=French
fra=French
fsl=French Sign Language
fur=Friulian
ff=Fulah
ful=Fulah
flr=Fuliiru
fun=Fulni\u221a\u00a5
fum=Fum
ula=Fungwa
fvr=Fur
fuu=Furu
fut=Futuna-Aniwa
fuy=Fuyug
fwe=Fwe
fwa=Fw\u221a\u00a2i
pym=Fyam
fie=Fyer
gaa=Ga
gqa=Ga'anda
gdg=Ga'dang
ttb=Gaa
tbi=Gaam
gab=Gabri
xgf=Gabrielino-Fernande\u221a\u00b1o
gav=Gabutamon
gdk=Gadang
gad=Gaddang
gbk=Gaddi
ged=Gade
gda=Gade Lohar
gdh=Gadjerawang
gaj=Gadsup
gft=Gafat
gbu=Gagadu
gag=Gagauz
btg=Gagnoa B\u221a\u00a9t\u221a\u00a9
ggu=Gagu
bfu=Gahri
gbf=Gaikundi
gic=Gail
gcn=Gaina
gap=Gal
glo=Galambu
xga=Galatian
gbi=Galela
gar=Galeya
car=Galibi Carib
gce=Galice
gl=Galician
glg=Galician
xgl=Galindan
sdn=Gallurese Sardinian
adl=Galo
gal=Galoli
kgj=Gamale Kham
gma=Gambera
wof=Gambian Wolof
kld=Gamilaraay
gbl=Gamit
gak=Gamkonora
gmv=Gamo
bte=Gamo-Ningi
gan=Gan Chinese
gnq=Gana
gne=Ganang
lg=Ganda
lug=Ganda
gzn=Gane
gcd=Ganggalida
ggl=Ganglau
gnb=Gangte
gnl=Gangulu
gao=Gants
gza=Ganza
gnz=Ganzi
gga=Gao
pwg=Gapapaiwa
gbc=Garawa
gbm=Garhwali
cab=Garifuna
ilg=Garig-Ilgar
grt=Garo
gex=Garre
gyb=Garus
xgr=Garza
gaq=Gata'
gou=Gavar
gvo=Gavi\u221a\u00a3o Do Jiparan\u221a\u00b0
gwt=Gawar-Bati
gwd=Gawwada
gyl=Gayil
gay=Gayo
gzi=Gazi
gbr=Gbagyi
gbv=Gbanu
gbg=Gbanziri
gby=Gbari
gti=Gbati-ri
gba=Gbaya (Central African Republic)
krs=Gbaya (Sudan)
gbp=Gbaya-Bossangoa
gbq=Gbaya-Bozoum
gmm=Gbaya-Mbodomo
gyg=Gbayi
gbs=Gbesi Gbe
ggb=Gbii
grh=Gbiri-Niragu
gec=Gboloo Grebo
hmj=Ge
kvq=Geba Karen
gei=Gebe
gdd=Gedaged
drs=Gedeo
gez=Geez
gji=Geji
ghk=Geko Karen
nlg=Gela
gio=Gelao
geq=Geme
gej=Gen
gaf=Gende
geg=Gengle
ka=Georgian
kat=Georgian
ygp=Gepo
gew=Gera
de=German
deu=German
gsg=German Sign Language
gea=Geruma
ges=Geser-Gorom
guv=Gey
gha=Ghadam\u221a\u00aes
gse=Ghanaian Sign Language
ghn=Ghanongga
gri=Ghari
bmk=Ghayavi
aln=Gheg Albanian
ghr=Ghera
gdo=Ghodoberi
gho=Ghomara
bbj=Ghom\u221a\u00b0l\u221a\u00b0'
aaa=Ghotuo
ghl=Ghulfan
bgi=Giangan
gib=Gibanawa
gid=Gidar
kks=Giiwo
acd=Gikyode
glk=Gilaki
gil=Gilbertese
gix=Gilima
niv=Gilyak
gim=Gimi (Eastern Highlands)
gip=Gimi (West New Britain)
kmp=Gimme
gmn=Gimnime
gnm=Ginuman
ayg=Ginyanga
bbr=Girawa
nyf=Giryama
toh=Gitonga
ggt=Gitua
git=Gitxsan
giy=Giyug
tof=Gizrra
glr=Glaro-Twabo
glw=Glavda
oub=Glio-Oubi
gnu=Gnau
gom=Goan Konkani
gig=Goaria
goi=Gobasi
gox=Gobu
god=Godi\u221a\u00a9
gdx=Godwari
ank=Goemai
gof=Gofa
gog=Gogo
ggw=Gogodala
gkn=Gokana
gol=Gola
gvf=Golin
gon=Gondi
goo=Gone Dau
goe=Gongduk
gjn=Gonja
gni=Gooniyandi
gqr=Gor
goc=Gorakor
goq=Gorap
gor=Gorontalo
grq=Gorovu
gow=Gorowa
got=Gothic
goy=Goundo
gux=Gourmanch\u221a\u00a9ma
goj=Gowlan
gok=Gowli
gwf=Gowro
goz=Gozarkhani
nli=Grangali
kbk=Grass Koiari
grb=Grebo
gss=Greek Sign Language
giq=Green Gelao
gcl=Grenadian Creole English
grs=Gresi
gro=Groma
gos=Gronings
ats=Gros Ventre
gwx=Gua
gcf=Guadeloupean Creole French
guh=Guahibo
gub=Guajaj\u221a\u00b0ra
gvj=Guaj\u221a\u00b0
gum=Guambiano
gqn=Guana (Brazil)
gva=Guana (Paraguay)
gvc=Guanano
gnc=Guanche
jiq=Guanyinqiao
gn=Guarani
grn=Guarani
gyr=Guarayu
gae=Guarequena
gsm=Guatemalan Sign Language
gta=Guat\u221a\u2265
guo=Guayabero
nji=Gudanji
gde=Gude
gdu=Gudu
gdf=Guduf-Gava
amu=Guerrero Amuzgo
ngu=Guerrero Nahuatl
zpg=Guevea De Humboldt Zapotec
ggd=Gugadj
gdc=Gugu Badhun
wrw=Gugu Warra
kkp=Gugubera
kky=Guguyimidjir
ghs=Guhu-Samane
gcr=Guianese Creole French
zgb=Guibei Zhuang
bet=Guiberoua B\u221a\u00a9te
zgn=Guibian Zhuang
gkp=Guinea Kpelle
gus=Guinean Sign Language
gqi=Guiqiong
gu=Gujarati
guj=Gujarati
gju=Gujari
kcm=Gula (Central African Republic)
glu=Gula (Chad)
glj=Gula Iro
gmb=Gula'alaa
gvl=Gulay
gly=Gule
afb=Gulf Arabic
gli=Guliguli
gmu=Gumalu
gnn=Gumatj
gvs=Gumawana
guk=Gumuz
guw=Gun
gdi=Gundi
gyf=Gungabula
rub=Gungu
gnt=Guntai
gup=Gunwinggu
gyy=Gunya
gpa=Gupa-Abawa
guf=Gupapuyngu
gge=Guragone
grz=Guramalum
hac=Gurani
gdj=Gurdjar
gnr=Gureng Gureng
ggg=Gurgula
grx=Guriaso
gue=Gurinji
gvm=Gurmana
goa=Guro
grd=Guruntum-Mbaaru
gsn=Gusan
guz=Gusii
gsl=Gusilay
gwu=Guwamu
gka=Guya
gyn=Guyanese Creole English
gvy=Guyani
ngs=Gvoko
gwb=Gwa
dah=Gwahatike
bga=Gwamhi-Wuri
gwn=Gwandara
grw=Gweda
gwe=Gweno
gwr=Gwere
gwi=Gwich\u00a0\u00bain
gyi=Gyele
gye=Gyem
ztu=G\u221a\u00bail\u221a\u00b0 Zapotec
haq=Ha
hbu=Habu
hdy=Hadiyya
hoj=Hadothi
xhd=Hadrami
ayh=Hadrami Arabic
hts=Hadza
aek=Haeke
hah=Hahon
hgm=Hai//om
hai=Haida
hgw=Haigwai
bzx=Hainyaxo Bozo
haf=Haiphong Sign Language
has=Haisla
hat=Haitian
ht=Haitian
hvc=Haitian Vodoun Culture Language
hji=Haji
haj=Hajong
cnh=Haka Chin
hak=Hakka Chinese
hao=Hak\u221a\u2202
hal=Halang
hld=Halang Doan
hlb=Halbi
khk=Halh Mongolian
hla=Halia
hur=Halkomelem
hmu=Hamap
hba=Hamba
amf=Hamer-Banna
hmt=Hamtai
haa=Han
hag=Hanga
wos=Hanga Hundi
han=Hangaza
hni=Hani
lml=Hano
hab=Hanoi Sign Language
hnn=Hanunoo
xha=Harami
har=Harari
kjo=Harijan Kinnauri
hro=Haroi
hss=Harsusi
tmd=Haruai
hrk=Haruku
bgc=Haryanvi
hrz=Harzani
ybj=Hasha
mey=Hassaniyya
had=Hatam
xht=Hattic
ha=Hausa
hau=Hausa
hsl=Hausa Sign Language
yuf=Havasupai-Walapai-Yavapai
hvk=Haveke
hav=Havu
hwc=Hawai'i Creole English
hps=Hawai'i Pidgin Sign Language
haw=Hawaiian
hay=Haya
haz=Hazaragi
xed=Hdi
he=Hebrew
heb=Hebrew
heh=Hehe
hbn=Heiban
hei=Heiltsuk
scp=Helambu Sherpa
heg=Helong
nix=Hema
hem=Hemba
hed=Herd\u221a\u00a9
her=Herero
hz=Herero
llf=Hermit
xhr=Hernican
ham=Hewa
auk=Heyo
ghc=Hiberno-Scottish Gaelic
hib=Hibito
hid=Hidatsa
hlu=Hieroglyphic Luwian
mba=Higaonon
kjk=Highland Konjo
chd=Highland Oaxaca Chontal
poi=Highland Popoluca
azz=Highland Puebla Nahuatl
tos=Highland Totonac
acw=Hijazi Arabic
hij=Hijuk
hil=Hiligaynon
hir=Himarim\u221a\u00a3
hi=Hindi
hin=Hindi
hii=Hinduri
gin=Hinukh
hmo=Hiri Motu
ho=Hiri Motu
hit=Hittite
htu=Hitu
hiw=Hiw
hix=Hixkary\u221a\u00b0na
lic=Hlai
yhl=Hlepho Phowa
hle=Hlersu
hmr=Hmar
hmn=Hmong
mww=Hmong Daw
hmf=Hmong Don
hmv=Hmong D\u221a\u00a5
hnj=Hmong Njua
hmz=Hmong Shua
mrk=Hmwaveke
hoc=Ho
hos=Ho Chi Minh City Sign Language
win=Ho-Chunk
hoa=Hoava
hoh=Hoby\u221a\u2265t
hhi=Hoia Hoia
hoi=Holikachuk
hoy=Holiya
hod=Holma
hoo=Holoholo
hol=Holu
hom=Homa
hds=Honduras Sign Language
hks=Hong Kong Sign Language
how=Honi
hop=Hopi
hrm=Horned Miao
hor=Horo
hoe=Horom
ero=Horpa
hrr=Horuru
hot=Hote
hti=Hoti
hov=Hovongan
hhy=Hoyahoya
hoz=Hozo
hpo=Hpon
hra=Hrangkhol
hre=Hre
hru=Hruso
huo=Hu
hug=Huachipaeri
qub=Huallaga Hu\u221a\u00b0nuco Quechua
qvh=Huamal\u221a\u2260es-Dos de Mayo Hu\u221a\u00b0nuco Quechua
hub=Huambisa
var=Huarijio
hus=Huastec
hud=Huaulu
mau=Huautla Mazatec
nhq=Huaxcaleca Nahuatl
qwh=Huaylas Ancash Quechua
qvw=Huaylla Wanca Quechua
hbb=Huba
tee=Huehuetla Tepehua
hch=Huichol
huh=Huilliche
mxs=Huitepec Mixtec
czh=Huizhou Chinese
huw=Hukumina
hul=Hula
huy=Hulaul\u221a\u00b0
hui=Huli
huk=Hulung
hmb=Humburi Senni Songhay
huf=Humene
hut=Humla
dud=Hun-Saare
hke=Hunde
hnu=Hung
hum=Hungana
hu=Hungarian
hun=Hungarian
hsh=Hungarian Sign Language
nat=Hungworo
hkk=Hunjara-Kaina Ke
xhc=Hunnic
hrx=Hunsrik
huz=Hunzib
hup=Hupa
jup=Hupd\u221a\u00b4
hap=Hupla
xhu=Hurrian
geh=Hutterite German
hwo=Hwana
hya=Hya
jab=Hyam
hrt=H\u221a\u00a9rtevin
juh=H\u221a\u00b5ne
iwk=I-Wak
iai=Iaai
yml=Iamalele
iap=Iapama
ian=Iatmul
tmu=Iau
tek=Ibali Teke
ibl=Ibaloi
iba=Iban
ibg=Ibanag
iby=Ibani
ivb=Ibatan
xib=Iberian
ibb=Ibibio
ibi=Ibilo
ibn=Ibino
ibu=Ibu
ibr=Ibuoro
is=Icelandic
isl=Icelandic
icl=Icelandic Sign Language
bec=Iceve-Maci
dbj=Ida'an
ida=Idakho-Isukha-Tiriki
idt=Idat\u221a\u00a9
ide=Idere
ids=Idesa
idi=Idi
ido=Ido
io=Ido
idu=Idoma
idc=Idon
clk=Idu-Mishmi
ldb=Idun
viv=Iduna
iff=Ifo
ife=If\u221a\u00ae
igl=Igala
igg=Igana
ibo=Igbo
ig=Igbo
ige=Igede
ign=Ignaciano
ahl=Igo
nar=Iguta
igw=Igwe
ihp=Iha
ihb=Iha Based Pidgin
ihi=Ihievbe
vki=Ija-Zuba
ikx=Ik
ikk=Ika
ikz=Ikizu
iki=Iko
meb=Ikobi-Mena
ntk=Ikoma-Nata-Isenye
txi=Ikpeng
ikp=Ikpeshi
kpo=Ikposo
ikv=Iku-Gora-Ankwa
ikl=Ikulu
ikw=Ikwere
ilb=Ila
ila=Ile Ape
ili=Ili Turki
ilu=Ili'uun
mbi=Ilianen Manobo
xil=Illyrian
ilo=Iloko
ilk=Ilongot
ilv=Ilue
mlk=Ilwana
qvi=Imbabura Highland Quichua
imo=Imbongu
ime=Imeraguen
imn=Imonda
imr=Imroing
abx=Inabaknon
mzu=Inapang
smn=Inari Sami
ins=Indian Sign Language
idb=Indo-Portuguese
id=Indonesian
ind=Indonesian
bdl=Indonesian Bajau
inl=Indonesian Sign Language
idr=Indri
mvy=Indus Kohistani
xiv=Indus Valley Language
oin=Inebu One
inz=Inese\u221a\u00b1o
inb=Inga
izh=Ingrian
inh=Ingush
iti=Inlaod Itneg
ino=Inoke-Yate
loc=Inonhan
ior=Inor
nkf=Inpui Naga
igs=Interglossa
ia=Interlingua (International Auxiliary Language Association)
ina=Interlingua (International Auxiliary Language Association)
ie=Interlingue
ile=Interlingue
ils=International Sign
int=Intha
iku=Inuktitut
iu=Inuktitut
ik=Inupiaq
ipk=Inupiaq
iow=Iowa-Oto
azm=Ipalapa Amuzgo
ipo=Ipiko
ipi=Ipili
ass=Ipulo
iqu=Iquito
irr=Ir
ill=Iranun
irk=Iraqw
irh=Irarutu
iry=Iraya
ire=Iresim
bto=Iriga Bicolano
iri=Irigwe
ga=Irish
gle=Irish
isg=Irish Sign Language
iru=Irula
irn=Ir\u221a\u00b0ntxe
isa=Isabi
isn=Isanzu
agk=Isarog Agta
isc=Isconahua
igo=Isebe
its=Isekiri
inn=Isinai
srl=Isirawa
crb=Island Carib
icr=Islander Creole English
isd=Isnag
iso=Isoko
isr=Israeli Sign Language
mir=Isthmus Mixe
zai=Isthmus Zapotec
nhk=Isthmus-Cosoleacaque Nahuatl
nhx=Isthmus-Mecayapan Nahuatl
nhp=Isthmus-Pajapan Nahuatl
ist=Istriot
ruo=Istro Romanian
szv=Isu (Fako Division)
isu=Isu (Menchum Division)
it=Italian
ita=Italian
ise=Italian Sign Language
itv=Itawit
itl=Itelmen
ite=Itene
itr=Iteri
itx=Itik
itw=Ito
ito=Itonama
itm=Itu Mbon Uzo
mce=Itundujia Mixtec
itz=Itz\u221a\u00b0
ium=Iu Mien
ivv=Ivatan
atg=Ivbie North-Okpela-Arhe
ibd=Iwaidja
kbm=Iwal
iwm=Iwam
iwo=Iwur
ixc=Ixcatec
mzi=Ixcatl\u221a\u00b0n Mazatec
ixl=Ixil
vmj=Ixtayutla Mixtec
otz=Ixtenco Otomi
iya=Iyayu
uiv=Iyive
nca=Iyo
crq=Iyo'wujwa Chorote
crt=Iyojwa'ja Chorote
izr=Izere
izi=Izi-Ezaa-Ikwo-Mgbo
ijc=Izon
cbo=Izora
inp=I\u221a\u00b1apari
jbt=Jabut\u221a\u2260
jda=Jad
jdg=Jadgali
jah=Jah Hut
jad=Jahanka
awv=Jair Awyu
jat=Jakati
jak=Jakun
maj=Jalapa De D\u221a\u2260az Mazatec
bxl=Jalkunan
jcs=Jamaican Country Sign Language
jam=Jamaican Creole English
jaa=Jamamad\u221a\u2260
jax=Jambi Malay
mxt=Jamiltepec Mixtec
djm=Jamsay Dogon
jnd=Jandavra
djo=Jangkang
jna=Jangshung
jni=Janji
ja=Japanese
jpn=Japanese
jsl=Japanese Sign Language
jru=Japrer\u221a\u2260a
jqr=Jaqaru
jaf=Jara
jra=Jarai
anq=Jarawa (India)
jar=Jarawa (Nigeria)
ddj=Jaru
qxw=Jauja Wanca Quechua
jns=Jaunsari
jav=Javanese
jv=Javanese
jvd=Javindo
jaz=Jawe
jyy=Jaya
jeb=Jebero
jeh=Jeh
jhi=Jehai
tow=Jemez
bze=Jenaama Bozo
jeg=Jeng
xuj=Jennu Kurumba
jer=Jere
jek=Jeri Kuo
jee=Jerung
tmr=Jewish Babylonian Aramaic (ca. 200-1200 CE)
jpa=Jewish Palestinian Aramaic
jhs=Jhankot Sign Language
jio=Jiamao
jya=Jiarong
juo=Jiba
jib=Jibu
apj=Jicarilla Apache
jii=Jiiddu
jie=Jilbe
jil=Jilim
jim=Jimi (Cameroon)
jmi=Jimi (Nigeria)
jia=Jina
cjy=Jinyu Chinese
pnu=Jiongnai Bunu
jul=Jirel
jrr=Jiru
jit=Jita
kaj=Jju
job=Joba
jbr=Jofotek-Bromnya
dyo=Jola-Fonyi
csk=Jola-Kasa
jeu=Jonkor Bourmataguil
jos=Jordanian Sign Language
jrt=Jorto
jor=Jor\u221a\u00b0
jow=Jowulu
juu=Ju
ktz=Ju/'hoan
jun=Juang
jrb=Judeo-Arabic
jbe=Judeo-Berber
jge=Judeo-Georgian
yhd=Judeo-Iraqi Arabic
itk=Judeo-Italian
aju=Judeo-Moroccan Arabic
jpr=Judeo-Persian
jdt=Judeo-Tat
yud=Judeo-Tripolitanian Arabic
ajt=Judeo-Tunisian Arabic
jye=Judeo-Yemeni Arabic
jbu=Jukun Takum
jum=Jumjum
jus=Jumla Sign Language
jml=Jumli
inj=Jungle Inga
mxq=Juquila Mixe
bex=Jur Modo
juy=Juray
juc=Jurchen
jur=Jur\u221a\u222bna
jut=Jutish
mwb=Juwal
vmc=Juxtlahuaca Mixtec
jwi=Jwira-Pepesa
jua=J\u221a\u222bma
quc=K'iche'
xku=Kaamba
ldl=Kaan
gna=Kaansa
ksp=Kaba
kvf=Kabalai
kbd=Kabardian
xkp=Kabatei
xbx=Kabix\u221a\u2260
kbp=Kabiy\u221a\u00a9
klz=Kabola
onk=Kabore One
lkb=Kabras
uka=Kaburi
kbu=Kabutra
kea=Kabuverdianu
cwa=Kabwa
kcw=Kabwari
kab=Kabyle
kcx=Kachama-Ganjule
xac=Kachari
kfr=Kachchi
gjk=Kachi Koli
kac=Kachin
koe=Kacipo-Balesi
xkk=Kaco'
kzd=Kadai
kej=Kadar
kad=Kadara
kdu=Kadaru
kbc=Kadiw\u221a\u00a9u
kdv=Kado
ktp=Kaduo
kbr=Kafa
kpu=Kafoa
gel=Kag-Fer-Jiir-Koor-Ror-Us-Zuksun
kll=Kagan Kalagan
syw=Kagate
cgc=Kagayanen
kdm=Kagoma
xkg=Kagoro
kki=Kagulu
hka=Kahe
agw=Kahua
kct=Kaian
kzb=Kaibobo
kzp=Kaidipang
kbw=Kaiep
kep=Kaikadi
kzq=Kaike
kkq=Kaiku
zka=Kaimbulawa
xai=Kaimb\u221a\u00a9
kgp=Kaingang
ckr=Kairak
kxa=Kairiru
krd=Kairui-Midiki
kzm=Kais
kce=Kaivi
kgk=Kaiw\u221a\u00b0
tcq=Kaiy
ckq=Kajakse
xkj=Kajali
kag=Kajaman
kqf=Kakabai
kke=Kakabe
kka=Kakanda
kbf=Kakauhua
tbd=Kaki Ae
kxe=Kakihum
kkj=Kako
keo=Kakwa
mwp=Kala Lagaw Ya
kal=Kalaallisut
kl=Kalaallisut
kve=Kalabakan
ijn=Kalabari
kzz=Kalabra
kqe=Kalagan
kkf=Kalaktang Monpa
kmh=Kalam
gwc=Kalami
knz=Kalams\u221a\u00a9
wkl=Kalanadi
kck=Kalanga
kly=Kalao
kyl=Kalapuya
kba=Kalarko
kls=Kalasha
kln=Kalenjin
fla=Kalispel-Pend d'Oreille
xka=Kalkoti
ktg=Kalkutung
xal=Kalmyk
rmf=Kalo Finnish Romani
ywa=Kalou
bco=Kaluli
kli=Kalumpang
kdx=Kam
vkm=Kamakan
woi=Kamang
kbq=Kamano
kci=Kamantan
keq=Kamar
jmr=Kamara
kzx=Kamarian
kgx=Kamaru
xas=Kamas
klp=Kamasa
kms=Kamasau
kyk=Kamayo
kay=Kamayur\u221a\u00b0
xba=Kamba (Brazil)
kam=Kamba (Kenya)
ktb=Kambaata
kyy=Kambaira
xbr=Kambera
irx=Kamberau
xbw=Kambiw\u221a\u00b0
kmi=Kami (Nigeria)
kcu=Kami (Tanzania)
kcq=Kamo
kgq=Kamoro
xmu=Kamu
xla=Kamula
xvi=Kamviri
hig=Kamwe
xnb=Kanakanabu
knm=Kanamar\u221a\u2260
xns=Kanashi
soq=Kanasi
bjj=Kanauji
kqw=Kandas
gam=Kandawo
kbs=Kande
kbl=Kanembu
kyp=Kang
kcp=Kanga
kkv=Kangean
igm=Kanggape
kxs=Kangjia
kty=Kango (Bas-U\u221a\u00a9l\u221a\u00a9 District)
kzy=Kango (Tshopo District)
xnr=Kangri
ktk=Kaniet
kev=Kanikkaran
kdp=Kaningdon-Nindem
kzo=Kaningi
knr=Kaningra
wat=Kaninuwa
kmu=Kanite
kft=Kanjari
kbe=Kanju
kne=Kankanaey
kan=Kannada
kn=Kannada
kfi=Kannada Kurumba
kxn=Kanowit-Tanjong Melanau
kxo=Kano\u221a\u00a9
ksk=Kansa
xkt=Kantosi
khx=Kanu
kni=Kanufi
kau=Kanuri
kr=Kanuri
kny=Kanyok
kax=Kao
kqn=Kaonde
ykm=Kap
tbx=Kapin
xpn=Kapinaw\u221a\u00b0
kpg=Kapingamarangi
khp=Kapori
dju=Kapriman
kbi=Kaptiau
klo=Kapya
cak=Kaqchikel
kah=Kara (Central African Republic)
zra=Kara (Korea)
leu=Kara (Papua New Guinea)
reg=Kara (Tanzania)
kaa=Kara-Kalpak
krc=Karachay-Balkar
gbd=Karadjeri
mry=Karaga Mandaya
kim=Karagas
xkh=Karahawyana
kdr=Karaim
kpj=Karaj\u221a\u00b0
xqa=Karakhanid
xar=Karami
kdj=Karamojong
kzr=Karang
kth=Karanga
zkk=Karankawa
kyj=Karao
kgv=Karas
kpt=Karata
xrw=Karawa
mjw=Karbi
kbn=Kare (Central African Republic)
kmf=Kare (Papua New Guinea)
kai=Karekare
krl=Karelian
kyd=Karey
kbj=Kari
kgn=Karingani
kuq=Karipuna
kgm=Karip\u221a\u222bna
kmv=Karip\u221a\u222bna Creole French
kzw=Karir\u221a\u2260-Xoc\u221a\u2265
ktn=Kariti\u221a\u00a2na
kil=Kariya
vka=Kariyarra
yuj=Karkar-Yuri
krb=Karkin
kko=Karko
bbv=Karnai
arr=Karo (Brazil)
kxh=Karo (Ethiopia)
kyh=Karok
kyn=Karolanos
krx=Karon
kgw=Karon Dori
xkx=Karore
ccj=Kasanga
xsm=Kasem
kju=Kashaya
kas=Kashmiri
ks=Kashmiri
csb=Kashubian
ksn=Kasiguranin
kkz=Kaska
zsk=Kaskean
kgc=Kasseng
khs=Kasua
kgd=Kataang
ktq=Katabaga
xat=Katawixi
tmb=Katbol
xtc=Katcha-Kadugli-Miri
tkt=Kathoriya Tharu
ykt=Kathu
bsh=Kati
kfu=Katkari
kcr=Katla
ktw=Kato
kaf=Katso
kta=Katua
kav=Katuk\u221a\u2260na
pss=Kaulong
vkk=Kaur
bpp=Kaure
zku=Kaurna
xau=Kauwera
ckv=Kavalan
krv=Kavet
kcb=Kawacha
xaw=Kawaiisu
kgb=Kawe
kaw=Kawi
ktx=Kaxarar\u221a\u2260
kbb=Kaxui\u221a\u00a2na
kyz=Kayab\u221a\u2260
kyt=Kayagar
pdu=Kayan
xay=Kayan Mahakam
xkn=Kayan River Kayan
kak=Kayapa Kallahan
txu=Kayap\u221a\u2265
gyd=Kayardild
kzl=Kayeli
kxy=Kayong
kyv=Kayort
gbb=Kaytetye
kzu=Kayupulau
kaz=Kazakh
kk=Kazakh
kzk=Kazukuru
xxk=Ke'o
keh=Keak
khz=Keapara
meo=Kedah Malay
ksx=Kedang
kdy=Keder
khh=Kehu
kei=Kei
kec=Keiga
bmh=Kein
eyo=Keiyo
kek=Kekch\u221a\u2260
kel=Kela (Democratic Republic of Congo)
kcl=Kela (Papua New Guinea)
kzi=Kelabit
khy=Kele (Democratic Republic of Congo)
sbc=Kele (Papua New Guinea)
ify=Keley-I Kallahan
kbo=Keliko
xel=Kelo
kyo=Kelon
kem=Kemak
xem=Kembayan
bzp=Kemberano
xkw=Kembra
dmo=Kemezung
sjk=Kemi Sami
kfj=Kemiehua
kmt=Kemtuik
gat=Kenati
knx=Kendayan
klf=Kendeje
kvm=Kendem
kyq=Kenga
kxi=Keningau Murut
knl=Keninjal
kns=Kensiu
ndb=Kenswei Nsei
kzh=Kenuzi-Dongola
xki=Kenyan Sign Language
ken=Kenyang
lke=Kenyi
xeu=Keoru-Ahia
kpn=Kepkiriw\u221a\u00b0t
kuk=Kepo'
ker=Kera
hhr=Kerak
xke=Kereho
krk=Kerek
ked=Kerewe
kxz=Kerewo
kvr=Kerinci
xes=Kesawai
ket=Ket
kae=Ketangalan
kcv=Kete
xte=Ketengban
ktt=Ketum
kyg=Keyagana
xkv=Kgalagadi
kjh=Khakas
kjf=Khalaj
klr=Khaling
kbg=Khamba
khg=Khams Tibetan
kht=Khamti
ksu=Khamyang
ogo=Khana
khn=Khandesi
kca=Khanty
xao=Khao
kfw=Kharam Naga
khr=Kharia
ksy=Kharia Thar
kha=Khasi
lko=Khayo
zkz=Khazar
kqg=Khe
tlx=Khehek
xkf=Khengkha
xhe=Khetrani
nkh=Khezha Naga
kix=Khiamniungan Naga
kjj=Khinalugh
kwx=Khirwar
kqm=Khisa
llo=Khlor
ykl=Khlula
kjg=Khmu
xkc=Kho'ini
nkb=Khoibu Naga
ktc=Kholok
kmz=Khorasani Turkish
zkh=Khorezmian
kho=Khotanese
khw=Khowar
xhv=Khua
khf=Khuen
cka=Khumi Awa Chin
cnk=Khumi Chin
kfm=Khunsari
khv=Khvarshi
kjm=Kh\u221a\u00b0ng
kkh=Kh\u221a\u00ban
kie=Kibet
prm=Kibiri
kic=Kickapoo
kzg=Kikai
ki=Kikuyu
kik=Kikuyu
sjd=Kildin Sami
kij=Kilivila
klb=Kiliwa
kih=Kilmeri
kia=Kim
mji=Kim Mun
kig=Kimaama
kqr=Kimaragang
kiv=Kimbu
kmb=Kimbundu
sbt=Kimki
kqp=Kimr\u221a\u00a9
kco=Kinalakna
krj=Kinaray-A
zga=Kinga
kfk=Kinnauri
knq=Kintaq
kkd=Kinuku
kin=Kinyarwanda
rw=Kinyarwanda
ues=Kioko
kkm=Kiong
xko=Kiorr
kio=Kiowa
apk=Kiowa Apache
sgc=Kipsigis
kyi=Kiput
kkr=Kir-Balar
geb=Kire
kir=Kirghiz
ky=Kirghiz
okr=Kirike
kiy=Kirikiri
kiu=Kirmanjki (individual language)
kis=Kis
lks=Kisa
kqh=Kisankasa
kje=Kisar
kiz=Kisi
gru=Kistane
mwk=Kita Maninkakan
zkt=Kitan
gia=Kitja
kii=Kitsai
mkw=Kituba (Congo)
ktu=Kituba (Democratic Republic of Congo)
kla=Klamath-Modoc
klu=Klao
kqt=Klias River Kadazan
tlh=Klingon
czk=Knaanic
fuj=Ko
kib=Koalib
cku=Koasati
kpd=Koba
kcj=Kobiana
kgu=Kobol
kpw=Kobon
kdq=Koch
thq=Kochila Tharu
cdz=Koda
ksz=Kodaku
kfa=Kodava
vko=Kodeoha
kod=Kodi
kwp=Kodia
kcs=Koenoem
kso=Kofa
kpi=Kofei
kwl=Kofyar
zkg=Koguryo
kkx=Kohin
plk=Kohistani Shina
kpm=Koho
bcs=Kohumono
kkt=Koi
zkb=Koibal
nkd=Koireng
kqi=Koitabu
kxt=Koiwat
trp=Kok Borok
ktd=Kokata
kou=Koke
xod=Kokoda
kzn=Kokola
kkk=Kokota
ekl=Kol
biw=Kol (Cameroon)
kol=Kol (Papua New Guinea)
kvv=Kola
klc=Kolbila
skn=Kolibugan Subanon
klm=Kolom
dkl=Kolum So Dogon
klx=Koluwawa
bkm=Kom (Cameroon)
kmm=Kom (India)
kmy=Koma
kpf=Komba
tyn=Kombai
xbi=Kombio
kge=Komering
kom=Komi
kv=Komi
koi=Komi-Permyak
kpv=Komi-Zyrian
xoi=Kominimung
kmw=Komo (Democratic Republic of Congo)
xom=Komo (Sudan)
kvh=Komodo
kvp=Kompane
kzv=Komyandaret
kkn=Kon Keu
kxw=Konai
knd=Konda
kfc=Konda-Dora
kdw=Koneraw
kg=Kongo
kon=Kongo
knn=Konkani (individual language)
kok=Konkani (macrolanguage)
xon=Konkomba
kma=Konni
knu=Kono (Guinea)
klk=Kono (Nigeria)
kno=Kono (Sierra Leone)
koa=Konomala
kcz=Konongo
kxc=Konso
nbe=Konyak Naga
mku=Konyanka Maninka
koo=Konzo
kng=Koongo
ozm=Koonzime
kqy=Koorete
xop=Kopar
opk=Kopkaka
kpr=Korafe-Yegha
koz=Korak
kqz=Korana
kcy=Korandje
ko=Korean
kor=Korean
kvk=Korean Sign Language
coe=Koreguaje
okh=Koresh-e Rostam
kfq=Korku
vkp=Korlai Creole Portuguese
kfo=Koro (C\u221a\u00a5te d'Ivoire)
kxr=Koro (Papua New Guinea)
krf=Koro (Vanuatu)
kfz=Koromf\u221a\u00a9
kqj=Koromira
bpr=Koronadal Blaan
xkq=Koroni
krp=Korop
xxr=Korop\u221a\u2265
ktl=Koroshi
khe=Korowai
kfd=Korra Koraga
xor=Korubo
kpq=Korupun-Sela
kfp=Korwa
kpy=Koryak
kiq=Kosadle
kkl=Kosarek Yale
kze=Kosena
kid=Koshin
kos=Kosraean
koq=Kota (Gabon)
kfe=Kota (India)
mqg=Kota Bangun Kutai Malay
grm=Kota Marudu Talantang
ktr=Kota Marudu Tinagas
kqk=Kotafon Gbe
avk=Kotava
eko=Koti
zko=Kott
kyf=Kouya
kqb=Kovai
kvc=Kove
xow=Kowaki
kwh=Kowiai
kqd=Koy Sanjaq Surat
kff=Koya
kga=Koyaga
koh=Koyo
khq=Koyra Chiini Songhay
ses=Koyraboro Senni Songhai
koy=Koyukon
kuw=Kpagua
kpl=Kpala
kpk=Kpan
pbn=Kpasam
koc=Kpati
kym=Kpatili
kpe=Kpelle
kef=Kpessi
kph=Kplang
kye=Krache
xra=Krah\u221a\u00a5
rka=Kraol
kqq=Krenak
zkv=Krevinian
xre=Kreye
xri=Krikati-Timbira
krm=Krim
kri=Krio
rop=Kriol
ksi=Krisa
kxb=Krobu
kgo=Krongo
krr=Kru'ng 2
jct=Krymchak
kry=Kryts
tyu=Kua
uan=Kuan
xnh=Kuanhua
ksd=Kuanua
kj=Kuanyama
kua=Kuanyama
kgf=Kube
kof=Kubi
jko=Kubo
kvb=Kubu
lkc=Kucong
kfg=Kudiya
kyw=Kudmali
kov=Kudu-Camo
kow=Kugama
kes=Kugbo
kxu=Kui (India)
kvd=Kui (Indonesia)
dkr=Kuijau
kui=Kuik\u221a\u222bro-Kalap\u221a\u00b0lo
vkj=Kujarge
kfn=Kuk
kux=Kukatja
kez=Kukele
kex=Kukna
xmq=Kuku-Mangk
xmp=Kuku-Mu'inh
xmh=Kuku-Muminh
ugb=Kuku-Ugbanh
uwa=Kuku-Uwanh
gvn=Kuku-Yalanji
tpg=Kula
kul=Kulere
kxj=Kulfa
xpk=Kulina Pano
vkl=Kulisusu
kfx=Kullu Pahari
uun=Kulon-Pazeh
kle=Kulung (Nepal)
bbu=Kulung (Nigeria)
nee=Kumak
ksl=Kumalu
kdi=Kumam
kue=Kuman
qwm=Kuman (Russia)
kfy=Kumaoni
kmj=Kumarbhag Paharia
ksm=Kumba
kgs=Kumbainggar
wkb=Kumbaran
xks=Kumbewaha
kra=Kumhali
dih=Kumiai
kuo=Kumukio
kum=Kumyk
zum=Kumzari
kun=Kunama
wlg=Kunbarlang
kdn=Kunda
wku=Kunduvadi
kfl=Kung
knw=Kung-Ekoka
ggk=Kungarakany
kvs=Kunggara
kgl=Kunggari
kse=Kuni
kvg=Kuni-Boazi
xug=Kunigami
kup=Kunimaipa
pep=Kunja
kjn=Kunjen
njx=Kunyi
kuz=Kunza
xuo=Kuo
kto=Kuot
kug=Kupa
mkn=Kupang Malay
key=Kupia
kpz=Kupsabiny
kuv=Kur
nqk=Kura Ede Nago
krh=Kurama
knk=Kuranko
ku=Kurdish
kur=Kurdish
nbn=Kuri
kuj=Kuria
kfh=Kurichiya
kfv=Kurmukar
vku=Kurrama
ktm=Kurti
xkz=Kurtokha
kjr=Kurudu
kru=Kurukh
kyr=Kuru\u221a\u00b0ya
kus=Kusaal
ksg=Kusaghe
kuh=Kushi
ksv=Kusu
kgg=Kusunda
ght=Kutang Ghale
kut=Kutenai
kub=Kutep
xut=Kuthant
kpa=Kutto
kdc=Kutu
khj=Kuturmi
kuy=Kuuku-Ya'u
kxv=Kuvi
blh=Kuwaa
cwt=Kuwaataay
kdt=Kuy
fkv=Kven Finnish
wka=Kw'adza
kwb=Kwa
bko=Kwa'
ksq=Kwaami
kwz=Kwadi
kwd=Kwaio
kdz=Kwaja
kwq=Kwak
kwk=Kwakiutl
kwu=Kwakum
qwt=Kwalhioqua-Tlatskanai
kmq=Kwama
kwm=Kwambi
tnk=Kwamera
ktf=Kwami
okk=Kwamtim One
kvi=Kwang
kwj=Kwanga
kwn=Kwangali
knp=Kwanja
kwf=Kwara'ae
nmg=Kwasio
kop=Kwato
kya=Kwaya
xwa=Kwaza
xwg=Kwegu
kwr=Kwer
kwe=Kwerba
xwr=Kwerba Mamberamo
cwe=Kwere
kkb=Kwerisa
kws=Kwese
kwt=Kwesten
gww=Kwini
kuc=Kwinsu
kww=Kwinti
kmo=Kwoma
kwo=Kwomtari
xuu=Kxoe
bka=Kyak
kyc=Kyaka
kql=Kyenele
tye=Kyenga
kgy=Kyerung
kmg=K\u221a\u00a2te
keb=K\u221a\u00a9l\u221a\u00a9
ksh=K\u221a\u2202lsch
lbi=La'bi
gdm=Laal
ldi=Laari
lau=Laba
lbb=Label
jku=Labir
mwi=Labo
ypb=Labo Phowa
lbu=Labu
dtb=Labuk-Kinabatangan Kadazan
lac=Lacandon
lbt=Lachi
zpa=Lachiguiri Zapotec
zpl=Lachix\u221a\u2260o Zapotec
lbj=Ladakhi
lld=Ladin
lad=Ladino
lkl=Laeko-Libuat
laf=Lafofa
lgb=Laghu
lgh=Laghuu
kot=Lagwan
lhh=Laha (Indonesia)
lha=Laha (Viet Nam)
lhn=Lahanan
lah=Lahnda
kvt=Lahta Karen
lhu=Lahu
lhi=Lahu Shi
lhl=Lahul Lohar
lmx=Laimbue
lji=Laiyolo
lbe=Lak
lap=Laka (Chad)
lak=Laka (Nigeria)
lka=Lakalei
lmw=Lake Miwok
lkh=Lakha
lki=Laki
lbc=Lakkia
lkn=Lakon
lkd=Lakond\u221a\u2122
lkt=Lakota
dic=Lakota Dida
nrz=Lala
leb=Lala-Bisa
lla=Lala-Roba
cnl=Lalana Chinantec
lal=Lalia
lay=Lama (Myanmar)
las=Lama (Togo)
slp=Lamaholot
lmr=Lamalera
lmm=Lamam
hia=Lamang
lmq=Lamatuka
lam=Lamba
lmn=Lambadi
quf=Lambayeque Quechua
lmh=Lambichhong
lmy=Lamboya
lai=Lambya
bma=Lame
lmu=Lamenu
lbn=Lamet
ldh=Lamja-Dengsa-Tola
lmk=Lamkang
lev=Lamma
lns=Lamnso'
lmg=Lamogai
ljp=Lampung Api
abl=Lampung Nyo
llh=Lamu
lby=Lamu-Lamu
ruu=Lanas Lobu
ldm=Landoma
yne=Lang'e
lnm=Langam
lna=Langbashe
lag=Langi
yln=Langnian Buyang
lno=Lango (Sudan)
laj=Lango (Uganda)
lng=Langobardic
sfb=Langue des signes de Belgique Francophone
lnh=Lanoh
lao=Lao
lo=Lao
lwm=Laomian
lbg=Laopang
lso=Laos Sign Language
ztl=Lapagu\u221a\u2260a-Guivini Zapotec
laa=Lapuyan Subanun
lrg=Laragia
lrt=Larantuka Malay
lbz=Lardil
lrv=Larevat
hmd=Large Flowery Miao
lrl=Lari
alo=Larike-Wakasihu
lro=Laro
lar=Larteh
lan=Laru
llm=Lasalimu
lsa=Lasgerdi
lsi=Lashi
lss=Lasi
ltc=Late Middle Chinese
la=Latin
lat=Latin
ltu=Latu
ltn=Latund\u221a\u2122
lav=Latvian
lv=Latvian
lsl=Latvian Sign Language
llu=Lau
luf=Laua
llx=Lauan
law=Lauje
lur=Laura
lre=Laurentian
lbv=Lavatbura-Lamusong
brb=Lave
lbo=Laven
lvk=Lavukaleve
lbx=Lawangan
tgi=Lawunuia
lya=Layakha
lzz=Laz
cle=Lealao Chinantec
lec=Leco
lew=Ledo Kaili
ldk=Leelau
lfa=Lefa
lgm=Lega-Mwenga
lea=Lega-Shabunda
agb=Legbo
lcc=Legenyem
tql=Lehali
urr=Lehalurup
cae=Lehar
lzn=Leinong Naga
lek=Leipon
llk=Lelak
lln=Lele (Chad)
lel=Lele (Democratic Republic of Congo)
llc=Lele (Guinea)
lle=Lele (Papua New Guinea)
lef=Lelemi
lpa=Lelepa
leq=Lembena
lrz=Lemerig
lei=Lemio
xle=Lemnian
ley=Lemolang
ldj=Lemoro
tnl=Lenakel
len=Lenca
led=Lendu
lgi=Lengilu
lgr=Lengo
lej=Lengola
leg=Lengua
lnj=Leningitij
leh=Lenje
ler=Lenkau
ldg=Lenyima
lep=Lepcha
lpe=Lepki
xlp=Lepontic
gnh=Lere
les=Lese
let=Lesing-Gelimi
nms=Letemboi
leo=Leti (Cameroon)
lti=Leti (Indonesia)
lvu=Levuka
lww=Lewo
lwe=Lewo Eleng
lwt=Lewotobi
ayi=Leyigha
lez=Lezghian
lhp=Lhokpu
lhm=Lhomi
ljl=Li'o
lix=Liabuku
ste=Liana-Seti
njn=Liangmai Naga
zln=Lianshan Zhuang
xpe=Liberia Kpelle
lir=Liberian English
liq=Libido
liz=Libinza
xli=Liburnian
ayl=Libyan Arabic
lbs=Libyan Sign Language
lig=Ligbi
lgz=Ligenza
lij=Ligurian
xlg=Ligurian (Ancient)
lih=Lihir
mgi=Lijili
lik=Lika
lio=Liki
lie=Likila
kxx=Likuba
lib=Likum
kwc=Likwala
lll=Lilau
lil=Lillooet
bme=Limassa
lif=Limbu
lmp=Limbum
li=Limburgan
lim=Limburgan
ylm=Limi
lmc=Limilngan
kmk=Limos Kalinga
klw=Lindu
lab=Linear A
lin=Lingala
ln=Lingala
onb=Lingao
lgk=Lingarak
lii=Lingkhim
pml=Lingua Franca
lfn=Lingua Franca Nova
apl=Lipan Apache
lpo=Lipo
lcs=Lisabata-Nuniali
lcl=Lisela
lsh=Lish
lsd=Lishana Deni
aij=Lishanid Noshan
trg=Lish\u221a\u00b0n Did\u221a\u00b0n
lis=Lisu
lzh=Literary Chinese
lit=Lithuanian
lt=Lithuanian
lls=Lithuanian Sign Language
lzl=Litzlitz
zlj=Liujiang Zhuang
zlq=Liuqian Zhuang
liv=Liv
olo=Livvi
lht=Lo-Toga
lrk=Loarki
loq=Lobala
lob=Lobi
lbm=Lodhi
lgq=Logba
log=Logo
lof=Logol
rag=Logooli
liu=Logorik
src=Logudorese Sardinian
qvj=Loja Highland Quichua
jbo=Lojban
yaz=Lokaa
lok=Loko
lky=Lokoya
lcd=Lola
llq=Lolak
llg=Lole
llb=Lolo
loa=Loloda
ycl=Lolopo
loi=Loma (C\u221a\u00a5te d'Ivoire)
lom=Loma (Liberia)
lmv=Lomaiviti
rmi=Lomavren
lmo=Lombard
lmi=Lombi
loo=Lombo
ngl=Lomwe
lce=Loncong
lpn=Long Phuri Naga
ttw=Long Wat
lgu=Longgu
wok=Longto
lnu=Longuda
los=Loniu
crc=Lonwolwol
lnz=Lonzo
ldo=Loo
lop=Lopa
lov=Lopi
lpx=Lopit
lrn=Lorang
lnn=Lorediakarkar
spq=Loreto-Ucayali Spanish
uvl=Lote
njh=Lotha Naga
dtr=Lotud
loj=Lou
lou=Louisiana Creole French
lox=Loun
xlo=Loup A
xlb=Loup B
nds=Low German
loy=Lowa
cea=Lower Chehalis
dni=Lower Grand Valley Dani
sli=Lower Silesian
dsb=Lower Sorbian
tto=Lower Ta'oih
taa=Lower Tanana
kml=Lower Tanudan Kalinga
clo=Lowland Oaxaca Chontal
tac=Lowland Tarahumara
ztp=Loxicha Zapotec
loz=Lozi
prb=Lua'
lex=Luang
lu=Luba-Katanga
lub=Luba-Katanga
lua=Luba-Lulua
kcc=Lubila
lcf=Lubu
knb=Lubuagan Kalinga
lch=Luchazi
luq=Lucumi
lud=Ludian
ldq=Lufu
lgg=Lugbara
ruf=Luguru
lcq=Luhu
lba=Lui
lum=Luimbi
lui=Luiseno
dop=Lukpa
smj=Lule Sami
luu=Lumba-Yakkha
lmz=Lumbee
lup=Lumbu
lmd=Lumun
luj=Luna
luk=Lunanakha
lun=Lunda
lnd=Lundayeh
lga=Lungga
luw=Luo (Cameroon)
luo=Luo (Kenya and Tanzania)
hml=Luopohe Hmong
ldd=Luri
lse=Lusengo
lus=Lushai
lut=Lushootseed
khl=Lusi
xls=Lusitanian
ndy=Lutos
lue=Luvale
luv=Luwati
lwo=Luwo
lb=Luxembourgish
ltz=Luxembourgish
lyn=Luyana
luy=Luyia
lwa=Lwalu
xlc=Lycian
xld=Lydian
lyg=Lyngngam
lsg=Lyons Sign Language
lee=Ly\u221a\u00a9l\u221a\u00a9
ldn=L\u221a\u00b0adan
bwj=L\u221a\u00b0\u221a\u00b0 L\u221a\u00b0\u221a\u00b0 Bwamu
khb=L\u221a\u00ba
msj=Ma (Democratic Republic of Congo)
mjn=Ma (Papua New Guinea)
mhy=Ma'anyan
mhi=Ma'di
slz=Ma'ya
cma=Maa
mew=Maaka
ffm=Maasina Fulfulde
ymm=Maay
mde=Maba (Chad)
mqa=Maba (Indonesia)
mmz=Mabaale
mfz=Mabaan
kkg=Mabaka Valley Kalinga
muj=Mabire
mca=Maca
mcl=Macaguaje
mbn=Macagu\u221a\u00b0n
mzs=Macanese
rup=Macedo-Romanian
mk=Macedonian
mkd=Macedonian
jmc=Machame
mcb=Machiguenga
mpd=Machinere
mvw=Machinga
wpc=Maco
myy=Macuna
mbc=Macushi
mxu=Mada (Cameroon)
mda=Mada (Nigeria)
mzc=Madagascar Sign Language
mmx=Madak
xmx=Maden
grg=Madi
zml=Madngele
kmd=Madukayang Kalinga
mad=Madurese
mme=Mae
hmk=Maek
itt=Maeng Itneg
maf=Mafa
mkv=Mafea
sgb=Mag-Anchi Ayta
blx=Mag-Indi Ayta
mtw=Magahat
mag=Magahi
xtm=Magdalena Pe\u221a\u00b1asco Mixtec
gmx=Magoma
zgr=Magori
mdh=Maguindanao
mjx=Mahali
bfz=Mahasu Pahari
mja=Mahei
mjy=Mahican
mhb=Mahongwe
mxx=Mahou
ayz=Mai Brat
sks=Maia
mzz=Maiadomu
tnh=Maiani
mmm=Maii
mgu=Mailu
cwb=Maindo
vmf=Mainfr\u221a\u00a7nkisch
xkl=Mainstream Kenyah
zrs=Mairasi
mbq=Maisin
mai=Maithili
wmm=Maiwa (Indonesia)
mti=Maiwa (Papua New Guinea)
mum=Maiwala
mpe=Majang
xmj=Majera
mjz=Majhi
mmj=Majhwar
mkg=Mak (China)
pbl=Mak (Nigeria)
mcp=Makaa
myh=Makah
mkz=Makasae
mak=Makasar
mfp=Makassar Malay
aup=Makayam
vmw=Makhuwa
xmc=Makhuwa-Marrevone
mgh=Makhuwa-Meetto
mhm=Makhuwa-Moniga
xsq=Makhuwa-Saka
vmk=Makhuwa-Shirima
mgf=Maklew
zmh=Makolkol
kde=Makonde
lva=Maku'a
jmn=Makuri Naga
mpu=Makur\u221a\u00b0p
ymk=Makwe
umn=Makyan Naga
mlf=Mal
mkb=Mal Paharia
ruy=Mala (Nigeria)
ped=Mala (Papua New Guinea)
ima=Mala Malasar
ccm=Malaccan Creole Malay
mcm=Malaccan Creole Portuguese
mg=Malagasy
mlg=Malagasy
mld=Malakhel
mmt=Malalamai
mln=Malango
mjo=Malankuravan
mjp=Malapandaram
mjq=Malaryan
mkr=Malas
mqz=Malasanga
ymr=Malasar
mjr=Malavedan
lon=Malawi Lomwe
swk=Malawi Sena
zlm=Malay (individual language)
ms=Malay (macrolanguage)
msa=Malay (macrolanguage)
mal=Malayalam
ml=Malayalam
xdy=Malayic Dayak
mlz=Malaynon
mbp=Malayo
xml=Malaysian Sign Language
bfo=Malba Birifor
mdy=Male (Ethiopia)
mdc=Male (Papua New Guinea)
pqm=Malecite-Passamaquoddy
pkt=Maleng
mgl=Maleu-Kilenge
mlx=Malfaxal
vml=Malgana
mxf=Malgbe
gcc=Mali
mwj=Maligo
mgq=Malila
mzd=Malimba
mli=Malimpung
tcf=Malinaltepec Me'phaa
mla=Malo
mbk=Malol
mlt=Maltese
mt=Maltese
mdl=Maltese Sign Language
mll=Malua Bay
mup=Malvi
gut=Mal\u221a\u00a9ku Ja\u221a\u2260ka
mam=Mam
mma=Mama
mhf=Mamaa
wmd=Mamaind\u221a\u00a9
mmn=Mamanwa
myk=Mamara Senoufo
mqj=Mamasa
mgm=Mambae
mcs=Mambai
mvd=Mamboru
mgr=Mambwe-Lungu
maw=Mampruli
mqx=Mamuju
emm=Mamulique
kdf=Mamusi
mdi=Mamvu
mml=Man Met
xmm=Manado Malay
mva=Manam
mle=Manambu
nmm=Manangba
znk=Manangkari
mnc=Manchu
zma=Manda (Australia)
mha=Manda (India)
mgs=Manda (Tanzania)
mht=Mandahuaca
mid=Mandaic
mhq=Mandan
zmk=Mandandanyi
mdr=Mandar
tbf=Mandara
mqu=Mandari
cmn=Mandarin Chinese
mjl=Mandeali
mqr=Mander
man=Mandingo
mnk=Mandinka
mfv=Mandjak
aax=Mandobo Atas
bwp=Mandobo Bawah
jet=Manem
zng=Mang
kby=Manga Kanuri
mem=Mangala
mpc=Mangarayi
mrv=Mangareva
zns=Mangas
myj=Mangayat
mdj=Mangbetu
mdk=Mangbutu
zme=Mangerr
mmo=Mangga Buang
mqy=Manggarai
mge=Mango
mqc=Mangole
mbh=Mangseng
xmn=Manichaean Middle Persian
xkb=Manigri-Kambol\u221a\u00a9 Ede Nago
mnx=Manikion
mqp=Manipa
mni=Manipuri
knf=Mankanya
mev=Mann
mju=Manna-Dora
mjv=Mannan
woo=Manombai
msk=Mansaka
mns=Mansi
msw=Mansoanka
myg=Manta
nty=Mantsi
kxf=Manumanaw Karen
wha=Manusela
glv=Manx
gv=Manx
mzj=Manya
mny=Manyawa
mxc=Manyika
mzv=Manza
nbi=Mao Naga
mmd=Maonan
swb=Maore Comorian
mi=Maori
mri=Maori
mlh=Mape
mnm=Mapena
mpy=Mapia
mpw=Mapidian
bzh=Mapos Buang
mcg=Mapoyo
arn=Mapudungun
sjm=Mapun
mch=Maquiritari
mec=Mara
mrh=Mara Chin
lri=Marachi
vmh=Maraghei
mrs=Maragus
nma=Maram Naga
lrm=Marama
myd=Maramba
mrw=Maranao
zmr=Maranunggu
mgb=Mararit
mar=Marathi
mr=Marathi
mvr=Marau
mpg=Marba
mrx=Maremgi
vmr=Marenje
mvu=Marfa
zmc=Margany
mrt=Marghi Central
mfm=Marghi South
qvm=Margos-Yarowilca-Lauricocha Quechua
mhg=Margu
mbx=Mari (East Sepik Province)
hob=Mari (Madang Province)
chm=Mari (Russia)
mrr=Maria (India)
mds=Maria (Papua New Guinea)
mrc=Maricopa
zmd=Maridan
zmj=Maridjabin
dad=Marik
zmm=Marimanindji
mrz=Marind
mbw=Maring
nng=Maring Naga
zmt=Maringarr
mrb=Marino
mqi=Mariri
mfr=Marithiel
nsr=Maritime Sign Language
msp=Maritsau\u221a\u00b0
zmy=Mariyedi
rkm=Marka
enb=Markweeta
rmz=Marma
mvo=Marovo
xru=Marriammu
umc=Marrucinian
mah=Marshallese
mh=Marshallese
ims=Marsian
mre=Martha's Vineyard Sign Language
zmg=Marti Ke
mpj=Martu Wangka
vma=Martuyhunira
mhx=Maru
mwr=Marwari
rwr=Marwari (India)
mve=Marwari (Pakistan)
mzr=Mar\u221a\u222bbo
myx=Masaaba
tis=Masadiit Itneg
mas=Masai
mls=Masalit
mcn=Masana
bks=Masbate Sorsogon
msb=Masbatenyo
cuj=Mashco Piro
jms=Mashi (Nigeria)
mho=Mashi (Zambia)
msh=Masikoro Malagasy
ism=Masimasi
bnf=Masiwang
klv=Maskelynes
mhh=Maskoy Pidgin
msv=Maslam
mes=Masmaje
mdg=Massalat
mvs=Massep
mtn=Matagalpa
mfh=Matal
xmt=Matbat
mgv=Matengo
mqe=Matepi
mbt=Matigsalug Manobo
mzo=Matipuhy
met=Mato
axg=Mato Grosso Ar\u221a\u00b0ra
mtm=Mator
ymt=Mator-Taygi-Karagas
mcf=Mats\u221a\u00a9s
mvb=Mattole
mjk=Matukar
mgw=Matumbi
stj=Matya Samo
mpq=Mat\u221a\u2260s
mph=Maung
mhl=Mauwake
mcw=Mawa (Chad)
wma=Mawa (Nigeria)
mjj=Mawak
mcz=Mawan
mzx=Mawayana
mke=Mawchi
mgk=Mawes
mbl=Maxakal\u221a\u2260
mxl=Maxi Gbe
sym=Maya Samo
xmy=Mayaguduna
myc=Mayeka
mnt=Maykulan
mfy=Mayo
mdm=Mayogo
ifu=Mayoyao Ifugao
dkx=Mazagway
zpy=Mazaltepec Zapotec
mzn=Mazanderani
vmz=Mazatl\u221a\u00b0n Mazatec
mzl=Mazatl\u221a\u00b0n Mixe
mfc=Mba
vmb=Mbabaram
mdp=Mbala
lnb=Mbalanhu
zmz=Mbandja
mxg=Mbangala
mgn=Mbangi
zmn=Mbangwe
mvl=Mbara (Australia)
mpk=Mbara (Chad)
zmv=Mbariman-Gudhinma
mdn=Mbati
gwa=Mbato
myb=Mbay
mfo=Mbe
mtk=Mbe'
xmd=Mbedam
mql=Mbelime
mdt=Mbere
zms=Mbesa
mbo=Mbo (Cameroon)
zmw=Mbo (Democratic Republic of Congo)
moi=Mboi
mdu=Mboko
mdq=Mbole
xmb=Mbonga
bgu=Mbongno
mdw=Mbosi
mxo=Mbowe
mka=Mbre
muc=Mbu'
mhd=Mbugu
mgz=Mbugwe
mqb=Mbuko
mhw=Mbukushu
mna=Mbula
mbu=Mbula-Bwazza
mlb=Mbule
mbv=Mbulungish
mdd=Mbum
mck=Mbunda
mgy=Mbunga
bbt=Mburku
mfu=Mbwela
gun=Mby\u221a\u00b0 Guaran\u221a\u2260
mym=Me'en
meg=Mea
mjm=Medebur
mue=Media Lengua
mwx=Mediak
xme=Median
mud=Mednyj Aleut
byv=Medumba
mfj=Mefele
mef=Megam
ruq=Megleno Romanian
nux=Mehek
mmh=Mehin\u221a\u00b0ku
gdq=Mehri
mek=Mekeo
mvk=Mekmek
msf=Mekwei
mxe=Mele-Fila
mfx=Melo
med=Melpa
mby=Memoni
xkd=Mendalam Kayan
mfd=Mendankwe-Nkwen
sim=Mende (Papua New Guinea)
men=Mende (Sierra Leone)
xmg=Mengaka
mee=Mengen
mct=Mengisa
mea=Menka
mez=Menominee
mwv=Mentawai
mcr=Menya
mvx=Meoswar
mnu=Mer
mxm=Meramera
lmb=Merei
meq=Merey
ulk=Meriam
mrm=Merlav
xmr=Meroitic
mer=Meru
wry=Merwari
iyo=Mesaka
apm=Mescalero-Chiricahua Apache
mci=Mese
sac=Meskwaki
zim=Mesme
mys=Mesmes
acm=Mesopotamian Arabic
mvz=Mesqan
cms=Messapic
mgo=Meta'
mxv=Metlat\u221a\u2265noc Mixtec
mtr=Mewari
wtm=Mewati
mfs=Mexican Sign Language
mej=Meyah
pbe=Mezontla Popoloca
ote=Mezquital Otomi
zmf=Mfinu
nfu=Mfumte
mic=Mi'kmaq
zam=Miahuatl\u221a\u00b0n Zapotec
mia=Miami
mpt=Mian
pla=Miani
crg=Michif
cmm=Michigamea
mmc=Michoac\u221a\u00b0n Mazahua
ncl=Michoac\u221a\u00b0n Nahuatl
dnt=Mid Grand Valley Dani
bjo=Mid-Southern Banda
axm=Middle Armenian
xbm=Middle Breton
cnx=Middle Cornish
dum=Middle Dutch (ca. 1050-1350)
enm=Middle English (1100-1500)
frm=Middle French (ca. 1400-1600)
gmh=Middle High German (ca. 1050-1500)
htx=Middle Hittite
mga=Middle Irish (900-1200)
okm=Middle Korean (10th-16th cent.)
gml=Middle Low German
xng=Middle Mongolian
nwx=Middle Newar
mpl=Middle Watut
wlm=Middle Welsh
mei=Midob
mmy=Migaama
mpp=Migabac
mxj=Miju-Mishmi
mik=Mikasuki
ymh=Mili
mlj=Miltu
iml=Miluk
imy=Milyan
mnp=Min Bei Chinese
cdo=Min Dong Chinese
nan=Min Nan Chinese
czo=Min Zhong Chinese
hna=Mina (Cameroon)
myi=Mina (India)
inm=Minaean
min=Minangkabau
mcv=Minanibai
mvn=Minaveha
mpn=Mindiri
mko=Mingang Doso
xmf=Mingrelian
hto=Minica Huitoto
wii=Minidien
vmg=Minigir
omn=Minoan
mqq=Minokok
mnq=Minriq
mzt=Mintil
zgm=Minz Zhuang
yiq=Miqie
mwl=Mirandese
mvh=Mire
zrg=Mirgan
mrg=Miri
mmv=Miriti
mep=Miriwung
pmu=Mirpur Panjabi
mjs=Miship
mpx=Misima-Paneati
zaw=Mitla Zapotec
vmm=Mitlatongo Mixtec
mwu=Mittu
zmq=Mituku
mpo=Miu
vmi=Miwa
mfg=Mixifore
mix=Mixtepec Mixtec
zpm=Mixtepec Zapotec
mkf=Miya
mvi=Miyako
soy=Miyobe
mra=Mlabri
lhs=Mlahs\u221a\u2202
kja=Mlap
mlo=Mlomp
mmu=Mmaala
bfm=Mmen
gbn=Mo'da
obm=Moabite
mfq=Moba
mod=Mobilian
ahm=Mobumrin Aizi
old=Mochi
omc=Mochica
mhc=Mocho
moc=Mocov\u221a\u2260
mxd=Modang
el=Modern Greek (1453-)
ell=Modern Greek (1453-)
mqo=Modole
mvq=Moere
mif=Mofu-Gudur
mhj=Mogholi
mou=Mogum
mov=Mohave
moh=Mohawk
mof=Mohegan-Montauk-Narragansett
mow=Moi (Congo)
mxn=Moi (Indonesia)
mkp=Moikodi
mwz=Moingi
ymi=Moji
mqt=Mok
mwt=Moken
mft=Mokerang
mkj=Mokilese
mkm=Moklen
mkl=Mokole
bri=Mokpwe
vms=Moksela
mdf=Moksha
mbe=Molale
pwm=Molbog
vsi=Moldova Sign Language
bxc=Molengue
mox=Molima
aun=Molmo One
zmo=Molo
msl=Molof
mlw=Moloko
ver=Mom Jango
myl=Moma
msz=Momare
mso=Mombum
mmb=Momina
mqf=Momuna
mnw=Mon
mzg=Monastic Sign Language
npn=Mondropolon
mnd=Mond\u221a\u00a9
lol=Mongo
mgt=Mongol
bxm=Mongolia Buriat
mn=Mongolian
mon=Mongolian
msr=Mongolian Sign Language
mog=Mongondow
mnz=Moni
mom=Monimbo
mru=Mono (Cameroon)
mnh=Mono (Democratic Republic of Congo)
mte=Mono (Solomon Islands)
mnr=Mono (USA)
moo=Monom
nmh=Monsang Naga
moe=Montagnais
mtl=Montol
mxk=Monumbo
moj=Monzombo
gwg=Moo
crm=Moose Cree
mop=Mop\u221a\u00b0n Maya
moq=Mor (Bomberai Peninsula)
mhz=Mor (Mor Islands)
msg=Moraid
mze=Morawa
nhm=Morelos Nahuatl
xmo=Morerebi
msx=Moresada
mzq=Mori Atas
xmz=Mori Bawah
mdb=Morigi
mfe=Morisyen
mor=Moro
ary=Moroccan Arabic
xms=Moroccan Sign Language
mgc=Morokodo
bdo=Morom
mqn=Moronene
mok=Morori
mrp=Morouas
mrl=Mortlockese
mgd=Moru
mqv=Mosimo
mwy=Mosiro
mtj=Moskona
mos=Mossi
mtt=Mota
mlv=Motlav
meu=Motu
mwh=Mouk-Aria
kpx=Mountain Koiali
mzp=Movima
ity=Moyadan Itneg
nmo=Moyon Naga
mzy=Mozambican Sign Language
mxi=Mozarabic
mpi=Mpade
mpz=Mpi
mcx=Mpiemo
mgg=Mpongmpong
mpa=Mpoto
mvt=Mpotovoro
zmp=Mpuono
akc=Mpur
cmr=Mro Chin
mro=Mru
kqx=Mser
atl=Mt. Iraya Agta
agz=Mt. Iriga Agta
mtd=Mualang
tsx=Mubami
mub=Mubi
ymd=Muda
mwd=Mudbura
gau=Mudhili Gadaba
vmd=Mudu Koraga
wiv=Muduapa
udg=Muduga
aoj=Mufian
muk=Mugom
bmr=Muinane
mmk=Mukha-Dora
moz=Mukulu
mfw=Mulaha
mlm=Mulam
kpb=Mullu Kurumba
mpb=Mullukmulluk
mul=Multiple languages
vmu=Muluridyi
kqa=Mum
mzm=Mumuye
mnb=Muna
unx=Munda
boe=Mundabli
mua=Mundang
mnf=Mundani
unr=Mundari
mmf=Mundat
myu=Munduruk\u221a\u222b
mhk=Mungaka
mth=Munggui
mpv=Mungkip
myr=Muniche
mtc=Munit
mnj=Munji
umu=Munsee
mtq=Muong
asx=Muratayak
mxr=Murik (Malaysia)
mtf=Murik (Papua New Guinea)
rmh=Murkim
mur=Murle
mwf=Murrinh-Patha
muz=Mursi
huu=Murui Huitoto
mqw=Murupi
zmu=Muruwari
mmq=Musak
mmi=Musar
smm=Musasa
mse=Musey
mug=Musgu
xma=Mushungulu
mui=Musi
mje=Muskum
ttt=Muslim Tat
msu=Musom
emi=Mussau-Emira
muv=Muthuvan
tuc=Mutu
mvm=Muya
muy=Muyang
myw=Muyuw
ymz=Muzi
mcj=Mvanip
mxh=Mvuba
sur=Mwaghavul
wlc=Mwali Comorian
moa=Mwan
wmw=Mwani
mwa=Mwatebu
mwe=Mwera (Chimwera)
mjh=Mwera (Nyasa)
mws=Mwimbi-Muthambi
gmy=Mycenaean Greek
mye=Myene
yms=Mysian
nme=Mzieme Naga
gmd=M\u221a\u00b0ghd\u221a\u00a8
miq=M\u221a\u2260skito
mhn=M\u221a\u2265cheno
mwq=M\u221a\u00ban Chin
muh=M\u221a\u00band\u221a\u00ba
pmh=M\u0192\u00c5h\u0192\u00c5r\u0192\u00c5\u00b7\u03c0\u00a3\u00b7\u03c0\u2260ri Pr\u0192\u00c5krit
nqo=N'Ko
ngh=N/u
nbt=Na
nao=Naaba
nas=Naasioi
mne=Naba
naf=Nabak
mty=Nabi
ncd=Nachering
ndf=Nadruvian
mbj=Nad\u221a\u00b4b
nfr=Nafaanra
srf=Nafi
nxx=Nafri
jbn=Nafusi
nag=Naga Pidgin
nbg=Nagarchal
nxe=Nage
ngv=Nagumi
nlx=Nahali
nhh=Nahari
bio=Nai
ars=Najdi Arabic
nae=Naka'ela
nkj=Nakai
nib=Nakama
nak=Nakanai
nck=Nakara
nbk=Nake
mff=Naki
nax=Nakwi
nlc=Nalca
nss=Nali
nal=Nalik
naj=Nalu
ylo=Naluo Yi
nlz=Nal\u221a\u2202go
naq=Nama (Namibia)
nmx=Nama (Papua New Guinea)
nmk=Namakura
nkm=Namat
ncm=Nambo
nmq=Nambya
nnm=Namia
nvm=Namiae
nbs=Namibian Sign Language
naa=Namla
mxw=Namo
nmt=Namonuito
bwb=Namosi-Naitasiri-Serua
nmy=Namuyi
gld=Nanai
nnc=Nancere
nnb=Nande
niq=Nandi
sen=Nanerig\u221a\u00a9 S\u221a\u00a9noufo
ngr=Nanggu
nam=Nangikurrunggurr
nnk=Nankina
cox=Nanti
nnt=Nanticoke
afk=Nanubae
qvo=Napo Lowland Quechua
npy=Napu
npa=Nar Phu
nrb=Nara
nac=Narak
nrg=Narango
nxu=Narau
loh=Narim
nhr=Naro
nrm=Narom
nay=Narrinyeri
nnr=Narungga
nsy=Nasal
nvh=Nasarian
nsk=Naskapi
nts=Natagaimas
ntz=Natanzi
ais=Nataoran Amis
ncz=Natchez
ntm=Nateni
nte=Nathembo
nti=Natioro
ntu=Nat\u221a\u00bagu
nxa=Nauete
ynk=Naukan Yupik
ncn=Nauna
na=Nauru
nau=Nauru
nav=Navajo
nv=Navajo
nsw=Navut
nwr=Nawaru
nwa=Nawathinehena
nmz=Nawdm
naw=Nawuri
nbf=Naxi
noz=Nayi
nyq=Nayini
ncr=Ncane
nlu=Nchumbulu
nnz=Nda'nda'
gke=Ndai
ndk=Ndaka
ncp=Ndaktup
ndh=Ndali
ndm=Ndam
ndj=Ndamba
nda=Ndasa
ndc=Ndau
ned=Nde-Gbite
ndd=Nde-Nsele-Nta
nml=Ndemli
dne=Ndendeule
ndg=Ndengereko
eli=Nding
ndp=Ndo
ndw=Ndobo
nbb=Ndoe
ndz=Ndogo
ndl=Ndolo
nqm=Ndom
ndq=Ndombe
njd=Ndonde Hamba
ndo=Ndonga
ng=Ndonga
ndr=Ndoola
ndx=Nduga
nmd=Ndumu
nuh=Ndunda
ndt=Ndunga
ndv=Ndut
njt=Ndyuka-Trio Pidgin
wni=Ndzwani Comorian
nap=Neapolitan
nec=Nedebang
nef=Nefamese
dcr=Negerhollands
zmi=Negeri Sembilan Malay
neg=Negidal
nsn=Nehan
nif=Nek
nkg=Nekgini
nej=Neko
nek=Neku
nex=Neme
nem=Nemi
nqn=Nen
anh=Nend
yrk=Nenets
nen=Nengone
nei=Neo-Hittite
nsp=Nepalese Sign Language
ne=Nepali
nep=Nepali
kxl=Nepali Kurux
net=Nete
jas=New Caledonian Javanese
nzs=New Zealand Sign Language
new=Newari
ney=Neyo
nez=Nez Perce
hlt=Nga La
ntj=Ngaanyatjarra
nxg=Ngad'a
nju=Ngadjunmaya
nnf=Ngaing
nij=Ngaju
nud=Ngala
nig=Ngalakan
ngk=Ngalkbun
szb=Ngalum
nmc=Ngam
nbv=Ngamambo
sba=Ngambay
nmv=Ngamini
nbh=Ngamo
nio=Nganasan
nid=Ngandi
ngd=Ngando (Central African Republic)
nxd=Ngando (Democratic Republic of Congo)
nne=Ngandyera
gng=Ngangam
nyx=Nganyaywana
nbj=Ngarinman
ung=Ngarinyin
nlr=Ngarla
nrl=Ngarluma
anc=Ngas
nsg=Ngasa
ngm=Ngatik Men's Creole
cnw=Ngawn Chin
nxn=Ngawun
zdj=Ngazidja Comorian
nga=Ngbaka
nbm=Ngbaka Ma'bo
ngg=Ngbaka Manza
jgb=Ngbee
nbd=Ngbinda
nuu=Ngbundu
agh=Ngelima
nge=Ngemba
ngt=Ngeq
nnn=Ngete
nbq=Nggem
ngx=Nggwahyi
ngj=Ngie
nnh=Ngiemboon
jle=Ngile
nnq=Ngindo
niy=Ngiti
ngi=Ngizim
kcd=Ngk\u221a\u00a2lmpw Kanum
nra=Ngom
jgo=Ngomba
nla=Ngombale
nmj=Ngombe (Central African Republic)
ngc=Ngombe (Democratic Republic of Congo)
nnx=Ngong
noq=Ngongo
ngo=Ngoni
nsh=Ngoshie
nlo=Ngul
ngp=Ngulu
nuw=Nguluwan
nui=Ngumbi
ndn=Ngundi
nue=Ngundu
ngz=Ngungwel
nbx=Ngura
ngq=Ngurimi
nrx=Ngurmbur
nuo=Ngu\u221a\u00a5n
ngw=Ngwaba
nwe=Ngwe
ngn=Ngwo
gym=Ng\u221a\u00a7bere
nha=Nhanda
yrl=Nhengatu
nhf=Nhuwala
nia=Nias
bzk=Nicaragua Creole English
ncs=Nicaraguan Sign Language
nie=Niellim
mzk=Nigeria Mambila
fuv=Nigerian Fulfulde
pcm=Nigerian Pidgin
nsi=Nigerian Sign Language
nll=Nihali
nii=Nii
nad=Nijadali
gbe=Niksek
nil=Nila
nim=Nilamba
noe=Nimadi
nmp=Nimanbur
nmr=Nimbari
nir=Nimboran
nis=Nimi
niw=Nimo
nmw=Nimoa
shb=Ninam
nxi=Nindi
nby=Ningera
nxr=Ninggerum
niz=Ningil
nns=Ningye
nlk=Ninia Yali
nin=Ninzo
nps=Nipsan
njs=Nisa
nsz=Nisenan
ncg=Nisga'a
yso=Nisi (China)
dap=Nisi (India)
num=Niuafo'ou
nkp=Niuatoputapu
niu=Niuean
cag=Nivacl\u221a\u00a9
njl=Njalgulgule
nzb=Njebi
njj=Njen
njr=Njerep
njy=Njyem
nkn=Nkangala
nkz=Nkari
isi=Nkem-Nkum
khu=Nkhumbi
nkc=Nkongho
nko=Nkonya
nkx=Nkoroo
nka=Nkoya
nbo=Nkukoli
nkw=Nkutu
nbp=Nnam
zxx=No linguistic content
fia=Nobiin
gaw=Nobonob
nom=Nocam\u221a\u00b0n
njb=Nocte Naga
nog=Nogai
noi=Noiri
nkk=Nokuku
lem=Nomaande
nof=Nomane
not=Nomatsiguenga
noh=Nomu
zhn=Nong Zhuang
nok=Nooksack
snf=Noon
nhu=Noone
noo=Nootka
cya=Nopala Chatino
nrc=Noric
nrn=Norn
nrr=Norra
esi=North Alaskan Inupiatun
mmg=North Ambrym
nks=North Asmat
yir=North Awyu
azj=North Azerbaijani
bcd=North Babar
qul=North Bolivian Quechua
neq=North Central Mixe
llp=North Efate
fll=North Fali
gis=North Giziga
qvn=North Jun\u221a\u2260n Quechua
apc=North Levantine Arabic
mrq=North Marquesan
ayp=North Mesopotamian Arabic
mfk=North Mofu
max=North Moluccan Malay
kti=North Muyu
nd=North Ndebele
nde=North Ndebele
nni=North Nuaulu
nrp=North Picene
scs=North Slavey
tbg=North Tairora
tnn=North Tanna
whg=North Wahgi
una=North Watut
weo=North Wemale
kiw=Northeast Kiwai
nmu=Northeast Maidu
aee=Northeast Pashayi
dip=Northeastern Dinka
pef=Northeastern Pomo
tts=Northeastern Thai
aqn=Northern Alta
atv=Northern Altai
ryn=Northern Amami-Oshima
bfc=Northern Bai
bmm=Northern Betsimisaraka Malagasy
bbo=Northern Bobo Madar\u221a\u00a9
cts=Northern Catanduanes Bicolano
qxn=Northern Conchucos Ancash Quechua
dgi=Northern Dagara
doc=Northern Dong
crl=Northern East Cree
emp=Northern Ember\u221a\u00b0
frr=Northern Frisian
ghh=Northern Ghale
gno=Northern Gondi
gbo=Northern Grebo
huj=Northern Guiyang Hmong
hdn=Northern Haida
hno=Northern Hindko
hmi=Northern Huishui Hmong
nrt=Northern Kalapuya
xnn=Northern Kankanay
kxm=Northern Khmer
kqs=Northern Kissi
kmr=Northern Kurdish
lbr=Northern Lorung
lrc=Northern Luri
hmp=Northern Mashan Hmong
ymx=Northern Muji
ngb=Northern Ngbandi
yiv=Northern Nisu
nuv=Northern Nuni
nhy=Northern Oaxaca Nahuatl
cst=Northern Ohlone
onr=Northern One
pao=Northern Paiute
pmq=Northern Pame
pbu=Northern Pashto
qvz=Northern Pastaza Quichua
pej=Northern Pomo
ncj=Northern Puebla Nahuatl
pmi=Northern Pumi
hea=Northern Qiandong Miao
cng=Northern Qiang
nnl=Northern Rengma Naga
rog=Northern Roglai
se=Northern Sami
sme=Northern Sami
nsq=Northern Sierra Miwok
stb=Northern Subanen
thh=Northern Tarahumara
ntp=Northern Tepehuan
nod=Northern Thai
twf=Northern Tiwa
xtn=Northern Tlaxiaco Mixtec
tsp=Northern Toussian
tji=Northern Tujia
ttm=Northern Tutchone
uzn=Northern Uzbek
ykg=Northern Yukaghir
esk=Northwest Alaska Inupiatun
gya=Northwest Gbaya
mjd=Northwest Maidu
mxa=Northwest Oaxaca Mixtec
glh=Northwest Pashayi
diw=Northwestern Dinka
faz=Northwestern Fars
kfb=Northwestern Kolami
ojb=Northwestern Ojibwa
tmk=Northwestern Tamang
no=Norwegian
nor=Norwegian
nb=Norwegian Bokm\u221a\u2022l
nob=Norwegian Bokm\u221a\u2022l
nn=Norwegian Nynorsk
nno=Norwegian Nynorsk
nsl=Norwegian Sign Language
bly=Notre
ncf=Notsi
ntw=Nottoway
nwy=Nottoway-Meherrin
nov=Novial
noy=Noy
asj=Nsari
nse=Nsenga
nsc=Nshi
nsx=Nsongo
bud=Ntcham
nto=Ntomba
baf=Nubaca
kcn=Nubi
kte=Nubri
nus=Nuer
nnv=Nugunu (Australia)
yas=Nugunu (Cameroon)
noc=Nuk
mbr=Nukak Mak\u221a\u222b
klt=Nukna
nuc=Nukuini
nuq=Nukumanu
nkr=Nukuoro
nur=Nukuria
nbr=Numana-Nunku-Gbantu-Numbu
nop=Numanggang
sij=Numbami
tgs=Nume
kdk=Numee
nxm=Numidian
nun=Nung (Myanmar)
nut=Nung (Viet Nam)
nug=Nungali
nuy=Nunggubuyu
rin=Nungu
npb=Nupbikha
nup=Nupe-Nupe-Tako
nul=Nusa Laut
nuf=Nusu
nwb=Nyabwa
nev=Nyaheun
cbn=Nyahkur
nyy=Nyakyusa-Ngonde
nlj=Nyali
nmi=Nyam
nly=Nyamal
now=Nyambo
nwm=Nyamusa-Molo
mwn=Nyamwanga
nym=Nyamwezi
nyk=Nyaneka
nyp=Nyang'i
nyj=Nyanga
nyc=Nyanga-li
nnj=Nyangatom
nyb=Nyangbo
nny=Nyangga
nna=Nyangumarta
ny=Nyanja
nya=Nyanja
nyn=Nyankole
sev=Nyarafolo Senoufo
rim=Nyaturu
nyw=Nyaw
nyt=Nyawaygi
nba=Nyemba
nye=Nyengo
neh=Nyenkha
nyl=Nyeu
nyh=Nyigina
nyr=Nyiha (Malawi)
nih=Nyiha (Tanzania)
nkv=Nyika (Malawi and Zambia)
nkt=Nyika (Tanzania)
lid=Nyindrou
nyg=Nyindu
nuj=Nyole
muo=Nyong
nyd=Nyore
nyo=Nyoro
nyv=Nyulnyul
nys=Nyunga
nyu=Nyungwe
yly=Ny\u221a\u00a2layu
nzy=Nzakambay
nzk=Nzakara
nja=Nzanyi
nzi=Nzima
neo=N\u221a\u00b0-Meo
hux=N\u221a\u00bapode Huitoto
xoc=O'chi'chi'
tyh=O'du
bzy=Obanliku
obi=Obispe\u221a\u00b1o
obl=Oblo
obo=Obo Manobo
afz=Obokuitai
ann=Obolo
obu=Obulom
oca=Ocaina
oc=Occitan (post 1500)
oci=Occitan (post 1500)
mie=Ocotepec Mixtec
zac=Ocotl\u221a\u00b0n Zapotec
odk=Od
bhf=Odiai
kkc=Odoodee
odu=Odual
oda=Odut
opy=Ofay\u221a\u00a9
arc=Official Aramaic (700-300 BCE)
ofo=Ofo
ogc=Ogbah
ogb=Ogbia
ogg=Ogbogolo
ogu=Ogbronuagum
eri=Ogea
oia=Oirata
oj=Ojibwa
oji=Ojibwa
chj=Ojitl\u221a\u00b0n Chinantec
oka=Okanagan
okn=Oki-No-Erabu
oki=Okiek
oks=Oko-Eni-Osayen
okj=Oko-Juwoi
okb=Okobo
okd=Okodia
kqv=Okolod
opa=Okpamheri
okx=Okpe (Northwestern Edo)
oke=Okpe (Southwestern Edo)
opm=Oksapmin
oku=Oku
oar=Old Aramaic (up to 700 BCE)
oav=Old Avar
obt=Old Breton
obr=Old Burmese
och=Old Chinese
oco=Old Cornish
odt=Old Dutch
ang=Old English (ca. 450-1100)
fro=Old French (842-ca. 1400)
ofs=Old Frisian
oge=Old Georgian
goh=Old High German (ca. 750-1050)
oht=Old Hittite
ohu=Old Hungarian
sga=Old Irish (to 900)
ojp=Old Japanese
okl=Old Kentish Sign Language
oko=Old Korean (3rd-9th cent.)
omp=Old Manipuri
omr=Old Marathi
omx=Old Mon
non=Old Norse
onw=Old Nubian
oos=Old Ossetic
peo=Old Persian (ca. 600-400 B.C.)
pro=Old Proven\u221a\u00dfal (to 1500)
orv=Old Russian
osx=Old Saxon
osp=Old Spanish
oty=Old Tamil
otb=Old Tibetan
otk=Old Turkish
oui=Old Uighur
owl=Old Welsh
ole=Olekha
ong=Olo
olm=Oloma
olr=Olrat
lul=Olu'bo
iko=Olulumo-Ikom
plo=Oluta Popoluca
omg=Omagua
oma=Omaha-Ponca
acx=Omani Arabic
mgx=Omati
mbm=Ombamba
oml=Ombo
ome=Omejes
nht=Ometepec Nahuatl
omi=Omi
omk=Omok
omt=Omotik
omu=Omurano
ona=Ona
one=Oneida
oog=Ong
oni=Onin
onx=Onin Based Pidgin
onj=Onjob
ons=Ono
onn=Onobasulu
ono=Onondaga
ont=Ontenu
ojv=Ontong Java
oor=Oorlams
opo=Opao
opt=Opata
lgn=Opuuo
orn=Orang Kanaq
ors=Orang Seletar
sdr=Oraon Sadri
ore=Orej\u221a\u2265n
org=Oring
or=Oriya
ori=Oriya
nlv=Orizaba Nahuatl
orc=Orma
orz=Ormu
oru=Ormuri
orx=Oro
orw=Oro Win
oac=Oroch
ora=Oroha
oaa=Orok
okv=Orokaiva
bdu=Oroko
oro=Orokolo
om=Oromo
orm=Oromo
orh=Oroqen
bpk=Orowe
orr=Oruma
ury=Orya
osa=Osage
ost=Osatu
osc=Oscan
osi=Osing
oso=Ososo
os=Ossetian
oss=Ossetian
otd=Ot Danum
uta=Otank
oti=Oti
otr=Otoro
otw=Ottawa
ota=Ottoman Turkish (1500-1928)
lot=Otuho
otu=Otuke
oum=Ouma
oue=Ounge
stn=Owa
wsr=Owenia
owi=Owiniga
oyb=Oy
oyy=Oya'oya
oyd=Oyda
zao=Ozolotepec Zapotec
chz=Ozumac\u221a\u2260n Chinantec
pdi=Pa Di
pqa=Pa'a
blk=Pa'o Karen
pha=Pa-Hng
pma=Paama
sig=Paasaal
pcp=Pacahuara
qvp=Pacaraos Quechua
ems=Pacific Gulf Yupik
pac=Pacoh
pdo=Padoe
pkc=Paekche
pgn=Paelignian
pgi=Pagi
pae=Pagibete
pgu=Pagu
phr=Pahari-Potwari
lgt=Pahi
phv=Pahlavani
pal=Pahlavi
pta=Pai Tavytera
pri=Paic\u221a\u00c6
ppi=Paipai
pck=Paite Chin
pwn=Paiwan
pkg=Pak-Tong
pkn=Pakanha
pav=Paka\u221a\u00b0snovos
pks=Pakistan Sign Language
pku=Paku
kpp=Paku Karen
abw=Pal
plq=Palaic
plr=Palaka Senoufo
cpa=Palantla Chinantec
pau=Palauan
pln=Palenquero
pi=Pali
pli=Pali
plu=Palik\u221a\u222br
pcf=Paliyan
fap=Palor
plp=Palpa
pbz=Palu
ple=Palu'e
plz=Paluan
pmc=Palumata
bpx=Palya Bareli
pmn=Pam
pmb=Pambia
pmk=Pamlico
pmf=Pamona
hih=Pamosu
pam=Pampanga
att=Pamplona Atta
pnq=Pana (Burkina Faso)
pnz=Pana (Central African Republic)
lsp=Panamanian Sign Language
par=Panamint
pcr=Panang
qxh=Panao Hu\u221a\u00b0nuco Quechua
kre=Panar\u221a\u00b0
psn=Panasuan
pwb=Panawa
pnp=Pancana
tdb=Panchpargania
bkj=Pande
pag=Pangasinan
pgs=Pangseng
slm=Pangutaran Sama
pbr=Pangwa
pgg=Pangwali
pnr=Panim
pcg=Paniya
pa=Panjabi
pan=Panjabi
pax=Pankarar\u221a\u00a9
paz=Pankarar\u221a\u222b
pkh=Pankhu
pnc=Pannei
knt=Panoan Katuk\u221a\u2260na
pno=Panobo
pnw=Panytyima
ppa=Pao
top=Papantla Totonac
ppn=Papapana
dpp=Papar
pas=Papasena
pbo=Papel
ppe=Papi
pap=Papiamento
pat=Papitalai
ppu=Papora
pmy=Papuan Malay
ppm=Papuma
pzn=Para Naga
prc=Parachi
gug=Paraguayan Guaran\u221a\u2260
pak=Parakan\u221a\u00a3
agp=Paranan
paf=Paranaw\u221a\u00b0t
pbg=Paraujano
prk=Parauk
prw=Parawen
pch=Pardhan
pcl=Pardhi
ppt=Pare
pab=Parec\u221a\u2260s
pcj=Parenga
kvx=Parkari Koli
pbi=Parkwa
prp=Parsi
prd=Parsi-Dari
xpr=Parthian
paq=Parya
aap=Par\u221a\u00b0 Ar\u221a\u00b0ra
gvp=Par\u221a\u00b0 Gavi\u221a\u00a3o
psq=Pasi
yac=Pass Valley Yali
pbc=Patamona
ptn=Patani
pth=Patax\u221a\u2265 H\u221a\u00a3-Ha-H\u221a\u00a3e
ptp=Patep
pty=Pathiya
gfk=Patpatar
lae=Pattani
mfa=Pattani Malay
plh=Paulohi
pad=Paumar\u221a\u2260
bfb=Pauri Bareli
psm=Pauserna
pwa=Pawaia
paw=Pawnee
pmr=Paynamar
pai=Pe
pcb=Pear
pay=Pech
xpc=Pecheneg
nso=Pedi
pfe=Peere
ppq=Pei
pel=Pekal
bxd=Pela
ata=Pele-Ata
ppp=Pelende
aoc=Pemon
psg=Penang Sign Language
pek=Penchal
ums=Pendau
peg=Pengo
pdc=Pennsylvania German
pnh=Penrhyn
ptw=Pentlatch
wet=Perai
pea=Peranakan Indonesian
mvf=Peripheral Mongolian
pip=Pero
fa=Persian
fas=Persian
psc=Persian Sign Language
prl=Peruvian Sign Language
zpe=Petapa Zapotec
pex=Petats
pey=Petjo
mil=Pe\u221a\u00b1oles Mixtec
pfl=Pfaelzisch
prt=Phai
phk=Phake
ypa=Phala
phl=Phalura
phq=Phana'
phw=Phangduwali
pem=Phende
psp=Philippine Sign Language
phm=Phimbi
phn=Phoenician
ypg=Phola
yip=Pholo
nph=Phom Naga
pnx=Phong-Kniang
kjt=Phrae Pwo Karen
xpg=Phrygian
pht=Phu Thai
phu=Phuan
phd=Phudagi
pug=Phuie
phh=Phukha
ypm=Phuma
pho=Phunoi
phg=Phuong
ypp=Phupa
yph=Phupha
ypz=Phuza
ptr=Piamatsina
pin=Piame
pio=Piapoco
pid=Piaroa
pcd=Picard
cpu=Pichis Ash\u221a\u00a9ninka
xpi=Pictish
dep=Pidgin Delaware
pms=Piemontese
pij=Pijao
piz=Pije
pis=Pijin
plg=Pilag\u221a\u00b0
piv=Pileni
pia=Pima Bajo
piw=Pimbwe
pnn=Pinai-Hagahai
pif=Pingelapese
pii=Pini
pnv=Pinigura
pic=Pinji
mio=Pinotepa Nacional Mixtec
pti=Pintiini
piu=Pintupi-Luritja
pny=Pinyin
ppl=Pipil
myp=Pirah\u221a\u00a3
pir=Piratapuyo
bxi=Pirlatapa
pie=Piro
ppr=Piru
pig=Pisabo
tpp=Pisaflores Tepehua
psy=Piscataway
xps=Pisidian
pih=Pitcairn-Norfolk
sje=Pite Sami
pcn=Piti
pjt=Pitjantjatjara
pit=Pitta Pitta
pix=Piu
piy=Piya-Kwonci
crk=Plains Cree
psd=Plains Indian Sign Language
pmw=Plains Miwok
ktj=Plapo Krumen
plt=Plateau Malagasy
pdt=Plautdietsch
gob=Playero
pbv=Pnar
npo=Pochuri Naga
xpo=Pochutec
pdn=Podena
poy=Pogolo
pon=Pohnpeian
pok=Pokang\u221a\u00b0
pof=Poke
pkb=Pokomo
pox=Polabian
pld=Polari
plj=Polci
pl=Polish
pol=Polish
pso=Polish Sign Language
plb=Polonombauk
pmo=Pom
pmm=Pomo
ncc=Ponam
pod=Ponares
png=Pongu
pgy=Pongyong
pns=Ponosakan
pnt=Pontic
jac=Popti'
poc=Poqomam
poh=Poqomchi'
prh=Porohanon
psw=Port Sandwich
ptv=Port Vato
por=Portuguese
pt=Portuguese
psr=Portuguese Sign Language
pot=Potawatomi
pog=Potigu\u221a\u00b0ra
gdb=Pottangi Ollar Gadaba
pmx=Poumei Naga
bye=Pouye
pwr=Powari
pim=Powhatan
pyn=Poyan\u221a\u00b0wa
prn=Prasuni
pry=Pray 3
pre=Principense
prz=Providencia Sign Language
prg=Prussian
kvj=Psikye
puk=Pu Ko
cpx=Pu-Xian Chinese
pux=Puare
atp=Pudtol Atta
pue=Puelche
psl=Puerto Rican Sign Language
npu=Puimei Naga
pui=Puinave
pkp=Pukapuka
fuc=Pulaar
pup=Pulabu
fuf=Pular
puw=Puluwatese
pum=Puma
xpm=Pumpokol
yae=Pum\u221a\u00a9
pud=Punan Aput
pna=Punan Bah-Biau
pnm=Punan Batu 1
puf=Punan Merah
puc=Punan Merap
puj=Punan Tubu
xpu=Punic
qxp=Puno Quechua
puu=Punu
puo=Puoc
puq=Puquina
pru=Puragi
iar=Purari
tsz=Purepecha
prr=Puri
prx=Purik
puy=Purisime\u221a\u00b1o
pur=Purubor\u221a\u00b0
pub=Purum
puz=Purum Naga
ps=Pushto
pus=Pushto
mfl=Putai
put=Putoh
afe=Putukwam
xpy=Puyo
xpp=Puyo-Paekche
pyu=Puyuma
pme=Pwaamei
pop=Pwapwa
kjp=Pwo Eastern Karen
pww=Pwo Northern Karen
pwo=Pwo Western Karen
pcw=Pyapun
pye=Pye Krumen
pyy=Pyen
pby=Pyu
pyx=Pyu (Myanmar)
pbb=P\u221a\u00b0ez
pfa=P\u221a\u00b0\u221a\u00b0fang
lkr=P\u221a\u00a7ri
pev=P\u221a\u00a9mono
lme=P\u221a\u00a9v\u221a\u00a9
pko=P\u221a\u2202koot
kjb=Q'anjob'al
laq=Qabiao
byx=Qaqet
qxq=Qashqa'i
xqt=Qatabanian
alc=Qawasqar
ymq=Qila Muji
ahg=Qimant
zqe=Qiubei Zhuang
qua=Quapaw
fcs=Quebec Sign Language
yum=Quechan
qu=Quechua
que=Quechua
qya=Quenya
otq=Quer\u221a\u00a9taro Otomi
pxm=Quetzaltepec Mixe
qvy=Queyu
zpj=Quiavicuzas Zapotec
qui=Quileute
qun=Quinault
quq=Quinqui
ztq=Quioquitani-Quier\u221a\u2260 Zapotec
chq=Quiotepec Chinantec
qyp=Quiripi
rah=Rabha
rad=Rade
xrr=Raetic
raz=Rahambuu
mqk=Rajah Kabunsuwan Manobo
raj=Rajasthani
rjs=Rajbanshi
rji=Raji
rjg=Rajong
gra=Rajput Garasia
rkh=Rakahanga-Manihiki
rki=Rakhine
ral=Ralte
rma=Rama
rai=Ramoaaina
kjx=Ramopa
lje=Rampi
thr=Rana Tharu
rax=Rang
rgk=Rangkas
rnl=Ranglong
rkt=Rangpuri
rao=Rao
ray=Rapa
rap=Rapanui
kyx=Rapoisi
rpt=Rapting
lra=Rara Bakati'
rar=Rarotongan
rac=Rasawa
btn=Ratagnon
rth=Ratahan
rtw=Rathawi
bgd=Rathwi Bareli
rau=Raute
yea=Ravula
rwo=Rawa
raw=Rawang
jnl=Rawat
rwa=Rawo
zor=Ray\u221a\u2265n Zoque
rat=Razajerdi
gir=Red Gelao
atu=Reel
rej=Rejang
ree=Rejang Kayan
rei=Reli
bow=Rema
rmb=Rembarunga
reb=Rembong
rem=Remo
agv=Remontado Agta
rmp=Rempi
lkj=Remun
rel=Rendille
ren=Rengao
mnv=Rennell-Bellona
rsi=Rennellese Sign Language
rpn=Repanbitip
rer=Rer Bare
rea=Rerau
pgk=Rerep
res=Reshe
rgr=Res\u221a\u2260garo
ret=Retta
rey=Reyesano
ria=Riang (India)
ril=Riang (Myanmar)
ran=Riantana
rir=Ribun
rie=Rien
rkb=Rikbaktsa
zar=Rinc\u221a\u2265n Zapotec
rgu=Ringgou
rri=Ririo
rit=Ritarungo
riu=Riung
snj=Riverain Sango
rod=Rogo
rhg=Rohingya
rmm=Roma
rgn=Romagnol
rmx=Romam
ro=Romanian
ron=Romanian
rms=Romanian Sign Language
rge=Romano-Greek
rsb=Romano-Serbian
rmv=Romanova
rm=Romansh
roh=Romansh
rom=Romany
rol=Romblomanon
rof=Rombo
rmk=Romkun
cla=Ron
rng=Ronga
ror=Rongga
nbu=Rongmei Naga
rnp=Rongpo
roe=Ronji
rnn=Roon
rga=Roria
roo=Rotokas
rtm=Rotuman
rug=Roviana
pce=Ruching Palaung
rdb=Rudbari
rui=Rufiji
ruh=Ruga
dru=Rukai
ruz=Ruma
rbb=Rumai Palaung
klq=Rumu
rna=Runa
rn=Rundi
run=Rundi
rou=Runga
drg=Rungus
rnw=Rungwa
bxr=Russia Buriat
ru=Russian
rus=Russian
rsl=Russian Sign Language
rue=Rusyn
rut=Rutul
ruc=Ruuli
rnd=Ruund
rwk=Rwa
rcf=R\u221a\u00a9union Creole French
ksw=S'gaw Karen
sax=Sa
apb=Sa'a
snv=Sa'ban
scq=Sa'och
sav=Saafi-Saafi
raq=Saam
lsm=Saamia
sxr=Saaroa
saa=Saba
xsa=Sabaean
bsy=Sabah Bisaya
msi=Sabah Malay
sae=Saban\u221a\u2122
spy=Sabaot
sbv=Sabine
hvn=Sabu
sbo=Sab\u221a\u00bam
quv=Sacapulteco
sck=Sadri
skb=Saek
spd=Saep
saf=Safaliba
apz=Safeyoka
sbk=Safwa
sbm=Sagala
tga=Sagalla
ssy=Saho
saj=Sahu
aec=Saidi Arabic
acf=Saint Lucian Creole French
xsy=Saisiyat
sjl=Sajalong
sjb=Sajau Basap
sch=Sakachep
skg=Sakalava Malagasy
skm=Sakam
sku=Sakao
skt=Sakata
sak=Sake
skf=Sakirabi\u221a\u00b0
shq=Sala
slx=Salampasu
slr=Salar
sgu=Salas
qxl=Salasaca Highland Quichua
slq=Salchuq
sau=Saleman
sbe=Saliba
sln=Salinan
sdz=Sallands
sll=Salt-Yui
loe=Saluan
slj=Salum\u221a\u00b0
esn=Salvadoran Sign Language
snx=Sam
smd=Sama
smp=Samaritan
sam=Samaritan Aramaic
tmj=Samarokena
ysd=Samatao
smx=Samba
ccg=Samba Daka
ndi=Samba Leko
xab=Sambe
ssx=Samberigi
saq=Samburu
smh=Samei
smq=Samo
sm=Samoan
smo=Samoan
swm=Samosa
rav=Sampang
sxm=Samre
stu=Samtao
smv=Samvedi
ztm=San Agust\u221a\u2260n Mixtepec Zapotec
zpx=San Baltazar Loxicha Zapotec
cuk=San Blas Kuna
hve=San Dionisio Del Mar Huave
pow=San Felipe Otlaltepec Popoloca
hue=San Francisco Del Mar Huave
mat=San Francisco Matlatzinca
maa=San Jer\u221a\u2265nimo Tec\u221a\u2265atl Mazatec
poe=San Juan Atzingo Popoloca
mjc=San Juan Colorado Mixtec
zab=San Juan Guelav\u221a\u2260a Zapotec
xtj=San Juan Teita Mixtec
pps=San Lu\u221a\u2260s Temalacayuca Popoloca
pls=San Marcos Tlalcoyalco Popoloca
trq=San Mart\u221a\u2260n Itunyoso Triqui
qvs=San Mart\u221a\u2260n Quechua
huv=San Mateo Del Mar Huave
scf=San Miguel Creole French
mig=San Miguel El Grande Mixtec
xtp=San Miguel Piedras Mixtec
azg=San Pedro Amuzgos Amuzgo
zpf=San Pedro Quiatoni Zapotec
kwy=San Salvador Kongo
zpt=San Vicente Coatl\u221a\u00b0n Zapotec
ayn=Sanaani Arabic
sap=Sanapan\u221a\u00b0
sad=Sandawe
sng=Sanga (Democratic Republic of Congo)
xsn=Sanga (Nigeria)
myt=Sangab Mandaya
scg=Sanggau
snl=Sangil
sxn=Sangir
sgr=Sangisari
sgk=Sangkong
sgl=Sanglechi-Ishkashimi
sag=Sango
sg=Sango
nsa=Sangtam Naga
snq=Sangu (Gabon)
sbp=Sangu (Tanzania)
ysn=Sani
ysy=Sanie
sny=Saniyo-Hiyewe
msc=Sankaran Maninka
ssi=Sansi
sa=Sanskrit
san=Sanskrit
sca=Sansu
qxt=Santa Ana de Tusi Pasco Quechua
ztn=Santa Catarina Albarradas Zapotec
pca=Santa In\u221a\u00a9s Ahuatempan Popoloca
zpn=Santa In\u221a\u00a9s Yatzechi Zapotec
mdv=Santa Luc\u221a\u2260a Monteverde Mixtec
hvv=Santa Mar\u221a\u2260a Del Mar Huave
nhz=Santa Mar\u221a\u2260a La Alta Nahuatl
zpi=Santa Mar\u221a\u2260a Quiegolani Zapotec
mza=Santa Mar\u221a\u2260a Zacatepec Mixtec
cok=Santa Teresa Cora
sat=Santali
zpr=Santiago Xanica Zapotec
qus=Santiago del Estero Quichua
zas=Santo Domingo Albarradas Zapotec
xsu=Sanum\u221a\u00b0
spr=Saparua
krn=Sapo
spi=Saponi
sps=Saposa
spu=Sapuan
spc=Sap\u221a\u00a9
mwm=Sar
sre=Sara
koj=Sara Dunjo
sbz=Sara Kaba
kwg=Sara Kaba Deme
kwv=Sara Kaba N\u221a\u00b0\u221a\u2020
srm=Saramaccan
bps=Sarangani Blaan
mbs=Sarangani Manobo
zsa=Sarasira
sar=Saraveca
sc=Sardinian
srd=Sardinian
srh=Sarikoli
sdf=Sarli
srs=Sarsi
onp=Sartang
swy=Sarua
sdu=Sarudu
sra=Saruga
sas=Sasak
sxs=Sasaru
sdc=Sassarese Sardinian
stw=Satawalese
stq=Saterfriesisch
mav=Sater\u221a\u00a9-Maw\u221a\u00a9
sdl=Saudi Arabian Sign Language
skc=Sauk
psu=Sauraseni Pr\u0192\u00c5krit
saz=Saurashtra
srt=Sauri
mjt=Sauria Paharia
sao=Sause
ssj=Sausi
svr=Savara
sdg=Savi
svs=Savosavo
szw=Sawai
swr=Saweru
saw=Sawi
swt=Sawila
swn=Sawknah
sxw=Saxwe Gbe
say=Saya
pos=Sayula Popoluca
sco=Scots
gd=Scottish Gaelic
gla=Scottish Gaelic
xsc=Scythian
gul=Sea Island Creole English
kdg=Seba
sgw=Sebat Bet Gurage
sbx=Seberuang
sib=Sebop
snb=Sebuyau
sec=Sechelt
sey=Secoya
sed=Sedang
tvw=Sedoa
sos=Seeku
sge=Segai
seg=Segeju
sbg=Seget
sfw=Sehwi
ssg=Seimat
hik=Seit-Kaitetu
sek=Sekani
skp=Sekapan
skz=Sekar
skj=Seke (Nepal)
ske=Seke (Vanuatu)
syi=Seki
skx=Seko Padang
sko=Seko Tengah
lip=Sekpele
kgi=Selangor Sign Language
slu=Selaru
sly=Selayar
snw=Selee
spl=Selepet
sxl=Selian
sel=Selkup
slg=Selungai Murut
sws=Seluwasan
sea=Semai
sdm=Semandang
szc=Semaq Beri
sbr=Sembakung Murut
sza=Semelai
etz=Semimi
ssm=Semnam
smy=Semnani
xse=Sempan
seh=Sena
seq=Senara S\u221a\u00a9noufo
syn=Senaya
sej=Sene
see=Seneca
sds=Sened
szg=Sengele
snu=Senggi
spk=Sengo
ssz=Sengseng
sjs=Senhaja De Srair
sni=Sensi
set=Sentani
sez=Senthang Chin
std=Sentinel
spb=Sepa (Indonesia)
spe=Sepa (Papua New Guinea)
spm=Sepen
iws=Sepik Iwam
sry=Sera
skr=Seraiki
sr=Serbian
srp=Serbian
hbs=Serbo-Croatian
sh=Serbo-Croatian
swf=Sere
srr=Serer
sei=Seri
sve=Serili
kqu=Seroa
ser=Serrano
szd=Seru
srw=Serua
srk=Serudung Murut
seu=Serui-Laut
crs=Seselwa Creole French
stf=Seta
stm=Setaman
sbi=Seti
sta=Settla
ojs=Severn Ojibwa
sew=Sewa Bay
sze=Seze
scw=Sha
sdb=Shabak
sbf=Shabo
srz=Shahmirzadi
shm=Shahrudi
sha=Shall-Zwall
sqa=Shama-Sambuga
xsh=Shamang
ksb=Shambala
shn=Shan
swo=Shanenawa
sho=Shanga
jih=Shangzhai
mcd=Sharanahua
ssv=Shark Bay
swq=Sharwa
sht=Shasta
shj=Shatt
sqh=Shau
sjw=Shawnee
shx=She
shv=Shehri
swv=Shekhawati
moy=Shekkacho
she=Sheko
sth=Shelta
seb=Shempire Senoufo
shl=Shendu
scv=Sheni
bun=Sherbro
sdp=Sherdukpen
xsr=Sherpa
kip=Sheshi Kham
shr=Shi
ssh=Shihhi Arabic
gua=Shiki
shk=Shilluk
scl=Shina
snh=Shinabo
shp=Shipibo-Conibo
sxg=Shixing
sle=Sholaga
sii=Shom Peng
sn=Shona
sna=Shona
bcv=Shoo-Minda-Nye
cjs=Shor
shh=Shoshoni
shg=Shua
sdt=Shuadit
jiv=Shuar
suj=Shubi
sgh=Shughni
sts=Shumashti
scu=Shumcho
shs=Shuswap
ksa=Shuwa-Zamani
shw=Shwai
pll=Shwe Palaung
slw=Sialum
sif=Siamou
spg=Sian
snp=Siane
sya=Siang
sjr=Siar-Lak
mmp=Siawi
nco=Sibe
sdx=Sibu Melanau
sxc=Sicanian
scx=Sicel
ii=Sichuan Yi
iii=Sichuan Yi
scn=Sicilian
sqr=Siculo Arabic
sid=Sidamo
xsd=Sidetic
erg=Sie
sgx=Sierra Leone Sign Language
nsu=Sierra Negra Nahuatl
zaa=Sierra de Ju\u221a\u00b0rez Zapotec
sxe=Sighu
snr=Sihan
qws=Sihuas Ancash Quechua
ski=Sika
sky=Sikaiana
tty=Sikaritai
sik=Sikiana
sip=Sikkimese
bla=Siksika
skh=Sikule
slt=Sila
mks=Silacayoapan Mixtec
sbq=Sileibi
szl=Silesian
wul=Silimo
mkc=Siliput
xsp=Silopi
stv=Silt'e
sie=Simaa
sbw=Simba
smg=Simbali
smb=Simbari
sbb=Simbo
smz=Simeku
smr=Simeulue
smt=Simte
siu=Sinagen
sst=Sinasina
snc=Sinaugoro
sjn=Sindarin
sd=Sindhi
snd=Sindhi
sbn=Sindhi Bhil
xts=Sindihui Mixtec
sgm=Singa
sls=Singapore Sign Language
sgp=Singpho
si=Sinhala
sin=Sinhala
xti=Sinicahua Mixtec
skq=Sininkere
snz=Sinsauru
rmo=Sinte Romani
sys=Sinyar
xsi=Sio
snn=Siona
qum=Sipacapense
swj=Sira
fos=Siraya
ysr=Sirenik Yupik
sir=Siri
sri=Siriano
srq=Sirion\u221a\u2265
srx=Sirmauri
ssd=Siroi
sld=Sissala
sso=Sissano
sis=Siuslaw
siy=Sivandi
siw=Siwai
siz=Siwi
akp=Siwu
csy=Siyin Chin
ska=Skagit
svx=Skalvian
skw=Skepi Creole Dutch
sms=Skolt Sami
skv=Skou
den=Slave (Athapascan)
sk=Slovak
slk=Slovak
svk=Slovakian Sign Language
sl=Slovenian
slv=Slovenian
sfm=Small Flowery Miao
kxq=Sm\u221a\u00a7rky Kanum
sno=Snohomish
sox=So (Cameroon)
soc=So (Democratic Republic of Congo)
ssq=So'a
sob=Sobei
cso=Sochiapam Chinantec
xog=Soga
sog=Sogdian
soj=Soi
skk=Sok
sok=Sokoro
xso=Solano
sby=Soli
aaw=Solong
sol=Solos
smc=Som
so=Somali
som=Somali
sor=Somrai
smu=Somray
kgt=Somyev
shc=Sonde
sgo=Songa
sop=Songe
soo=Songo
soe=Songomeno
sod=Songoora
soi=Sonha
siq=Sonia
snk=Soninke
sov=Sonsorol
teu=Soo
urw=Sop
sqt=Soqotri
srb=Sora
sbh=Sori-Harengan
sqo=Sorkhei
sxo=Sorothaptic
ays=Sorsogon Ayta
sdk=Sos Kundi
krz=Sota Kanum
sqq=Sou
sfs=South African Sign Language
aws=South Awyu
azb=South Azerbaijani
quh=South Bolivian Quechua
lnl=South Central Banda
dib=South Central Dinka
erk=South Efate
fal=South Fali
giz=South Giziga
lmf=South Lembata
ajp=South Levantine Arabic
mqm=South Marquesan
kts=South Muyu
nbl=South Ndebele
nr=South Ndebele
nxl=South Nuaulu
spx=South Picene
xsl=South Slavey
omw=South Tairora
cpy=South Ucayali Ash\u221a\u00a9ninka
mcy=South Watut
tlw=South Wemale
sns=South West Bay
tvk=Southeast Ambrym
vbb=Southeast Babar
ijs=Southeast Ijo
psi=Southeast Pashayi
dks=Southeastern Dinka
zpd=Southeastern Ixtl\u221a\u00b0n Zapotec
nit=Southeastern Kolami
mxy=Southeastern Nochixtl\u221a\u00b0n Mixtec
pom=Southeastern Pomo
npl=Southeastern Puebla Nahuatl
tcu=Southeastern Tarahumara
stp=Southeastern Tepehuan
agy=Southern Alta
alt=Southern Altai
ams=Southern Amami-Oshima
ayc=Southern Aymara
bfs=Southern Bai
bcc=Southern Balochi
bjq=Southern Betsimisaraka Malagasy
biv=Southern Birifor
bwq=Southern Bobo Madar\u221a\u00a9
caf=Southern Carrier
bln=Southern Catanduanes Bicolano
qxo=Southern Conchucos Ancash Quechua
dga=Southern Dagaare
kmc=Southern Dong
crj=Southern East Cree
ghe=Southern Ghale
ggo=Southern Gondi
grj=Southern Grebo
hmy=Southern Guiyang Hmong
hax=Southern Haida
hnd=Southern Hindko
sxk=Southern Kalapuya
ksc=Southern Kalinga
kss=Southern Kisi
kjd=Southern Kiwai
sdh=Southern Kurdish
ysp=Southern Lolopo
lrr=Southern Lorung
luz=Southern Luri
snm=Southern Ma'di
hma=Southern Mashan Hmong
mnn=Southern Mnong
ymc=Southern Muji
nab=Southern Nambiku\u221a\u00b0ra
nbw=Southern Ngbandi
nik=Southern Nicobarese
nsd=Southern Nisu
nnw=Southern Nuni
css=Southern Ohlone
osu=Southern One
pmz=Southern Pame
pbt=Southern Pashto
qup=Southern Pastaza Quechua
peq=Southern Pomo
mit=Southern Puebla Mixtec
slh=Southern Puget Sound Salish
pmj=Southern Pumi
hms=Southern Qiandong Miao
qxs=Southern Qiang
nre=Southern Rengma Naga
zsr=Southern Rincon Zapotec
rgs=Southern Roglai
ssb=Southern Sama
sma=Southern Sami
sbd=Southern Samo
skd=Southern Sierra Miwok
sot=Southern Sotho
st=Southern Sotho
sou=Southern Thai
tix=Southern Tiwa
wib=Southern Toussian
tjs=Southern Tujia
tce=Southern Tutchone
uzs=Southern Uzbek
yux=Southern Yukaghir
gso=Southwest Gbaya
plv=Southwest Palawano
psh=Southwest Pashayi
nwi=Southwest Tanna
dik=Southwestern Dinka
fay=Southwestern Fars
hmg=Southwestern Guiyang Hmong
hmh=Southwestern Huishui Hmong
nsv=Southwestern Nisu
tsf=Southwestern Tamang
twr=Southwestern Tarahumara
tla=Southwestern Tepehuan
meh=Southwestern Tlaxiaco Mixtec
sww=Sowa
sow=Sowanda
vmp=Soyaltepec Mazatec
vmq=Soyaltepec Mixtec
es=Spanish
spa=Spanish
ssp=Spanish Sign Language
spt=Spiti Bhoti
spo=Spokane
squ=Squamish
srn=Sranan Tongo
sci=Sri Lankan Creole Malay
sqs=Sri Lankan Sign Language
arb=Standard Arabic
ekk=Standard Estonian
zsm=Standard Malay
stl=Stellingwerfs
sbu=Stod Bhoti
sto=Stoney
str=Straits Salish
szp=Suabo
seo=Suarmin
swp=Suau
sxb=Suba
ssc=Suba-Simbiti
xsj=Subi
sbs=Subiya
sut=Subtiaba
apd=Sudanese Arabic
pga=Sudanese Creole Arabic
tgo=Sudest
xsv=Sudovian
sue=Suena
sgi=Suga
sug=Suganga
kzs=Sugut Dusun
swi=Sui
sui=Suki
sub=Suku
suk=Sukuma
syk=Sukur
zsu=Sukurum
szn=Sula
sua=Sulka
srg=Sulod
suv=Sulung
sqm=Suma
siv=Sumariup
six=Sumau
smw=Sumbawa
suw=Sumbwa
sux=Sumerian
nsm=Sumi Naga
sum=Sumo-Mayangna
ssk=Sunam
su=Sundanese
sun=Sundanese
suz=Sunwar
syo=Suoy
spp=Supyire Senoufo
tdl=Sur
sbj=Surbakhal
suq=Suri
sul=Surigaonon
sjp=Surjapuri
sgz=Sursurunga
swx=Suruah\u221a\u00b0
sde=Surubu
sru=Suru\u221a\u2260
mdz=Suru\u221a\u2260 Do Par\u221a\u00b0
sqn=Susquehannock
sus=Susu
ssu=Susuami
sdj=Suundi
swu=Suwawa
suy=Suy\u221a\u00b0
sva=Svan
swg=Swabian
swh=Swahili (individual language)
sw=Swahili (macrolanguage)
swa=Swahili (macrolanguage)
csw=Swampy Cree
ss=Swati
ssw=Swati
sv=Swedish
swe=Swedish
swl=Swedish Sign Language
gsw=Swiss German
ssr=Swiss-French Sign Language
sgg=Swiss-German Sign Language
slf=Swiss-Italian Sign Language
shz=Syenara Senoufo
syl=Sylheti
syr=Syriac
slc=S\u221a\u00b0liba
zkp=S\u221a\u00a3o Paulo Kaing\u221a\u00b0ng
cri=S\u221a\u00a3otomense
sep=S\u221a\u00a8c\u221a\u00a8t\u221a\u00a9 S\u221a\u00a9noufo
sss=S\u221a\u00a5
tct=T'en
acq=Ta'izzi-Adeni Arabic
tap=Taabwa
zat=Tabaa Zapotec
tby=Tabaru
chf=Tabasco Chontal
nhc=Tabasco Nahuatl
zoq=Tabasco Zoque
tab=Tabassaran
tnm=Tabla
knv=Tabo
tzx=Tabriak
xtt=Tacahua Mixtec
tna=Tacana
shy=Tachawit
shi=Tachelhit
lts=Tachoni
dsq=Tadaksahak
tdy=Tadyawan
rob=Tae'
tcd=Tafi
bgs=Tagabawa
klg=Tagakaulu Kalagan
mvv=Tagal Murut
tgl=Tagalog
tl=Tagalog
oua=Tagargrent
tbw=Tagbanwa
tbm=Tagbu
tda=Tagdal
tgx=Tagish
tag=Tagoi
tgw=Tagwana Senoufo
thv=Tahaggart Tamahaq
tah=Tahitian
ty=Tahitian
tht=Tahltan
taw=Tai
tyr=Tai Daeng
blt=Tai Dam
tyj=Tai Do
twh=Tai D\u221a\u2265n
thc=Tai Hang Tong
tiz=Tai Hongjin
tlq=Tai Loi
thi=Tai Long
tmp=Tai M\u221a\u00aene
tdd=Tai N\u221a\u00baa
tpo=Tai Pao
tmm=Tai Thanh
cuu=Tai Ya
gpn=Taiap
aos=Taikat
ago=Tainae
tnq=Taino
uar=Tairuma
dav=Taita
tss=Taiwan Sign Language
pee=Taje
tg=Tajik
tgk=Tajik
abh=Tajiki Arabic
tdj=Tajio
tja=Tajuasohn
tkm=Takelma
tks=Takestani
tbc=Takia
tkk=Takpa
tkz=Takua
nho=Takuu
tke=Takwane
tal=Tal
tak=Tala
tld=Talaud
tlv=Taliabu
tdf=Talieng
tlj=Talinga-Bwisi
tlr=Talise
tlo=Talodi
tlk=Taloki
tln=Talondo'
yta=Talu
ilw=Talur
tly=Talysh
tma=Tama (Chad)
ten=Tama (Colombia)
tcg=Tamagario
tmn=Taman (Indonesia)
tcl=Taman (Myanmar)
tmz=Tamanaku
tmh=Tamashek
taq=Tamasheq
vmx=Tamazola Mixtec
tdk=Tambas
xxt=Tambora
tls=Tambotalo
kzt=Tambunan Dusun
tmy=Tami
ta=Tamil
tam=Tamil
tax=Tamki
tml=Tamnim Citak
low=Tampias Lobu
tpu=Tampuan
tpm=Tampulma
tcb=Tanacross
tcm=Tanahmerah
tfn=Tanaina
tpv=Tanapag
tni=Tandia
tdx=Tandroy-Mahafaly Malagasy
tnx=Tanema
tan=Tangale
tnv=Tangchangya
tgg=Tangga
tgu=Tanggu
nmf=Tangkhul Naga
tkx=Tangko
ytl=Tanglang
tgp=Tangoa
tnf=Tangshewi
tbs=Tanguat
txg=Tangut
tbe=Tanimbili
tnc=Tanimuca-Retuar\u221a\u00a3
uji=Tanjijili
txy=Tanosy Malagasy
tza=Tanzanian Sign Language
tbb=Tapeba
afp=Tapei
tpj=Tapiet\u221a\u00a9
taf=Tapirap\u221a\u00a9
tro=Tarao Naga
tgr=Tareng
tae=Tariana
rif=Tarifit
yer=Tarok
trv=Taroko
tpf=Tarpia
txr=Tartessian
twq=Tasawaq
nst=Tase Naga
xtz=Tasmanian
tmt=Tasmate
cta=Tataltepec Chatino
txx=Tatana
tat=Tatar
tt=Tatar
tav=Tatuyo
ttd=Tauade
tuh=Taulil
tco=Taungyo
tpa=Taupota
tad=Tause
trr=Taushiro
tsg=Tausug
tya=Tauya
tvs=Taveta
tvn=Tavoyan
rmu=Tavringer Romani
tbo=Tawala
ttq=Tawallammat Tamajaq
xtw=Tawand\u221a\u2122
twm=Tawang Monpa
twl=Tawara
tbp=Taworta
twy=Tawoyan
tcp=Tawr Chin
tas=Tay Boi
tnu=Tay Khang
ayy=Tayabas Ayta
thz=Tayart Tamajeq
cks=Tayo
grr=Taznatit
tbl=Tboli
tck=Tchitchege
bqa=Tchumbuli
tve=Te'un
tkw=Teanu
tsy=Tebul Sign Language
dtu=Tebul Ure Dogon
tcw=Tecpatl\u221a\u00b0n Totonac
tuq=Tedaga
ctd=Tedim Chin
tkq=Tee
tfo=Tefaro
ras=Tegali
kps=Tehit
teh=Tehuelche
ztt=Tejalapan Zapotec
ebo=Teke-Ebo
ifm=Teke-Fuumu
kkw=Teke-Kukuya
lli=Teke-Laali
nzu=Teke-Nzikou
teg=Teke-Tege
tyi=Teke-Tsaayi
tyx=Teke-Tyee
ttc=Tektiteko
tvm=Tela-Masbuar
tlf=Telefol
te=Telugu
tel=Telugu
tlt=Teluti
kdh=Tem
tjo=Temacine Tamazight
nhv=Temascaltepec Nahuatl
tbt=Tembo (Kitembo)
tmv=Tembo (Motembo)
tqb=Temb\u221a\u00a9
tdo=Teme
teq=Temein
soz=Temi
tea=Temiar
ott=Temoaya Otomi
tmo=Temoq
tdu=Tempasuk Dusun
tmw=Temuan
quw=Tena Lowland Quichua
otn=Tenango Otomi
dtk=Tene Kan Dogon
vkt=Tenggarong Kutai Malay
tes=Tengger
pah=Tenharim
tqn=Tenino
tns=Tenis
tex=Tennet
tio=Teop
tev=Teor
tep=Tepecano
cnt=Tepetotutla Chinantec
cux=Tepeuxila Cuicatec
cte=Tepinapa Chinantec
ted=Tepo Krumen
sjt=Ter Sami
ttr=Tera
trb=Terebu
buo=Terei
ter=Tereno
tef=Teressa
twg=Tereweng
tfr=Teribe
tec=Terik
twu=Termanu
tft=Ternate
tmg=Ternate\u221a\u00b1o
keg=Tese
twc=Teshenawa
teo=Teso
tll=Tetela
nhg=Tetelcingo Nahuatl
teb=Tetete
tet=Tetum
tdt=Tetun Dili
cut=Teutila Cuicatec
twe=Tewa (Indonesia)
tew=Tewa (USA)
twx=Tewe
otx=Texcatepec Otomi
poq=Texistepec Popoluca
zpz=Texmelucan Zapotec
mxb=Tezoatl\u221a\u00b0n Mixtec
thy=Tha
thn=Thachanadan
tcz=Thado Chin
th=Thai
tha=Thai
tsq=Thai Sign Language
soa=Thai Song
ths=Thakali
nki=Thangal Naga
thf=Thangmi
ssf=Thao
thk=Tharaka
thd=Thayore
typ=Thaypan
thx=The
tou=Tho
thp=Thompson
ytp=Thopho
txh=Thracian
tyl=Thu Lao
thw=Thudam
tdh=Thulung
tbh=Thurawal
thu=Thuri
ahi=Tiagbamrin Aizi
mnl=Tiale
tbj=Tiang
ngy=Tibea
bo=Tibetan
bod=Tibetan
tcn=Tichurong
tca=Ticuna
mtx=Tida\u221a\u00b0 Mixtec
tia=Tidikelt Tamazight
tid=Tidong
tvo=Tidore
boo=Tiemac\u221a\u00aew\u221a\u00ae Bozo
tii=Tiene
tif=Tifal
tgc=Tigak
nza=Tigon Mbembe
tig=Tigre
ti=Tigrinya
tir=Tigrinya
txq=Tii
xtl=Tijaltepec Mixtec
tik=Tikar
tkp=Tikopia
otl=Tilapa Otomi
til=Tillamook
zts=Tilquiapan Zapotec
tij=Tilung
tms=Tima
tim=Timbe
tem=Timne
tvy=Timor Pidgin
tjm=Timucua
tih=Timugon Murut
lbf=Tinani
tin=Tindi
tie=Tingal
tgv=Tingui-Boto
tit=Tinigua
tne=Tinoc Kallahan
tpz=Tinputz
xsb=Tin\u221a\u2020 Sambal
tpe=Tippera
tic=Tira
tra=Tirahi
cir=Tiri
tiy=Tiruray
tdq=Tita
ttv=Titan
tiv=Tiv
lax=Tiwa
tiw=Tiwi
tiq=Ti\u221a\u00a9fo
boz=Ti\u221a\u00a9yaxo Bozo
tju=Tjurruru
tpt=Tlachichilco Tepehua
tpl=Tlacoapa Me'phaa
ctl=Tlacoatzintepec Chinantec
zpk=Tlacolulita Zapotec
mxp=Tlahuitoltepec Mixe
nuz=Tlamacazapa Nahuatl
mqh=Tlazoyaltepec Mixtec
tli=Tlingit
toz=To
mlu=To'abaita
tqo=Toaripi
tob=Toba
tmf=Toba-Maskoy
tgh=Tobagonian Creole English
tng=Tobanga
tti=Tobati
tlb=Tobelo
tox=Tobian
tgb=Tobilung
tbv=Tobo
asu=Tocantins Asurini
taz=Tocho
tcx=Toda
tdr=Todrah
tlg=Tofanma
tfi=Tofin Gbe
tor=Togbo-Vara Banda
tgy=Togoyo
ood=Tohono O'odham
toj=Tojolabal
tpi=Tok Pisin
zuh=Tokano
tkl=Tokelau
xto=Tokharian A
txb=Tokharian B
tkn=Toku-No-Shima
jic=Tol
lbw=Tolaki
tlm=Tolomako
tol=Tolowa
tod=Toma
tdi=Tomadino
ttp=Tombelala
txa=Tombonuo
tom=Tombulu
toe=Tomedes
txm=Tomini
dtm=Tomo Kan Dogon
tqp=Tomoip
tdn=Tondano
tog=Tonga (Nyasa)
tnz=Tonga (Thailand)
to=Tonga (Tonga Islands)
ton=Tonga (Tonga Islands)
toi=Tonga (Zambia)
tny=Tongwe
tjn=Tonjon
tqw=Tonkawa
tnw=Tonsawang
txs=Tonsea
tnt=Tontemboan
ttj=Tooro
toy=Topoiyo
toq=Toposa
sda=Toraja-Sa'dan
trj=Toram
ttu=Torau
fit=Tornedalen Finnish
tdv=Toro
dts=Toro So Dogon
dtt=Toro Tegu Dogon
tno=Toromono
tqr=Torona
tcs=Torres Strait Creole
tei=Torricelli
trw=Torwali
trz=Tor\u221a\u00b0
als=Tosk Albanian
ttl=Totela
txo=Toto
txe=Totoli
zph=Totomachapan Zapotec
mto=Totontepec Mixe
ttk=Totoro
tqu=Touo
neb=Toura (C\u221a\u00a5te d'Ivoire)
don=Toura (Papua New Guinea)
ttn=Towei
xtg=Transalpine Gaulish
rmd=Traveller Danish
rmg=Traveller Norwegian
trl=Traveller Scottish
trm=Tregami
tme=Trememb\u221a\u00a9
stg=Trieng
tip=Trimuris
tgq=Tring
trx=Tringgus-Sembaan Bidayuh
lst=Trinidad and Tobago Sign Language
trf=Trinidadian Creole English
trn=Trinitario
tri=Tri\u221a\u2265
tka=Truk\u221a\u00b0
tpy=Trumai
tsl=Ts'\u221a\u00ban-Lao
tsa=Tsaangi
tkr=Tsakhur
tsd=Tsakonian
kvz=Tsakwambo
tsb=Tsamai
huq=Tsat
tsk=Tseku
txc=Tsetsaut
tsj=Tshangla
kdl=Tsikimba
cas=Tsiman\u221a\u00a9
xmw=Tsimihety Malagasy
tsi=Tsimshian
tsw=Tsishingini
ldp=Tso
hio=Tsoa
tsv=Tsogo
ts=Tsonga
tso=Tsonga
fly=Tsotsitaal
lto=Tsotso
tsu=Tsou
ttz=Tsum
tvd=Tsuvadi
tsh=Tsuvan
tsc=Tswa
tn=Tswana
tsn=Tswana
two=Tswapong
mjg=Tu
pmt=Tuamotuan
tbu=Tubar
tuo=Tucano
tuy=Tugen
tzn=Tugun
tuj=Tugutil
khc=Tukang Besi North
bhq=Tukang Besi South
bag=Tuki
tpq=Tukpa
tkd=Tukudede
tkf=Tukumanf\u221a\u00a9d
tul=Tula
tlu=Tulehu
tey=Tulishi
tcy=Tulu
rak=Tulu-Bohuai
iou=Tuma-Irumu
tmc=Tumak
krt=Tumari Kanuri
tum=Tumbuka
kku=Tumi
tmq=Tumleo
xtq=Tumshuqese
tbr=Tumtum
sil=Tumulung Sisaala
mzb=Tumzabt
enh=Tundra Enets
baz=Tunen
lcm=Tungag
trt=Tunggare
tug=Tunia
tun=Tunica
aeb=Tunisian Arabic
tse=Tunisian Sign Language
tjg=Tunjung
tqq=Tunni
dza=Tunzu
ttf=Tuotomb
tpr=Tupar\u221a\u2260
tpn=Tupinamb\u221a\u00b0
tpk=Tupinikin
tui=Tupuri
tpw=Tup\u221a\u2260
trh=Turaka
trd=Turi
twt=Turiw\u221a\u00b0ra
tuz=Turka
tuv=Turkana
klj=Turkic Khalaj
tr=Turkish
tur=Turkish
tsm=Turkish Sign Language
tk=Turkmen
tuk=Turkmen
tch=Turks And Caicos Creole English
tru=Turoyo
tqm=Turumsa
try=Turung
tus=Tuscarora
tta=Tutelo
ttg=Tutong
tvt=Tutsa Naga
tmi=Tutuba
mtu=Tututepec Mixtec
tuu=Tututni
tvl=Tuvalu
tyv=Tuvinian
ifk=Tuwali Ifugao
tww=Tuwari
bov=Tuwuli
tux=Tuxin\u221a\u00b0wa
tud=Tux\u221a\u00b0
tue=Tuyuca
twa=Twana
twn=Twendi
twd=Twents
tw=Twi
twi=Twi
kcg=Tyap
woa=Tyaraity
tzj=Tz'utujil
tzh=Tzeltal
tzo=Tzotzil
tyz=T\u221a\u2020y
tys=T\u221a\u2020y Sa Pa
tyt=T\u221a\u2020y Tac
lor=T\u221a\u00a9\u221a\u00a9n
tub=T\u221a\u00babatulabal
uuu=U
aoz=Uab Meto
uam=Uamu\u221a\u00a9
ksj=Uare
byc=Ubaghara
uba=Ubang
ubi=Ubi
ubr=Ubir
uby=Ubykh
cpb=Ucayali-Yur\u221a\u222ba Ash\u221a\u00a9ninka
uda=Uda
udi=Udi
ude=Udihe
udm=Udmurt
udu=Uduk
ufi=Ufim
ugn=Ugandan Sign Language
uga=Ugaritic
uge=Ughele
ugo=Ugong
uha=Uhami
ug=Uighur
uig=Uighur
uis=Uisai
udj=Ujir
kcf=Ukaan
ukh=Ukhwejo
umi=Ukit
ukp=Ukpe-Bayobiri
akd=Ukpet-Ehom
uk=Ukrainian
ukr=Ukrainian
ukl=Ukrainian Sign Language
uku=Ukue
ukg=Ukuriguma
ukq=Ukwa
ukw=Ukwuani-Aboh-Ndoni
svb=Ulau-Suain
ulc=Ulch
uli=Ulithian
ull=Ullatan
ulb=Ulukwumi
ulm=Ulumanda'
ppk=Uma
xky=Uma' Lasan
ulu=Uma' Lung
gdn=Umanakaina
uma=Umatilla
umd=Umbindhamu
xum=Umbrian
ubu=Umbu-Ungu
umr=Umbugarla
umb=Umbundu
umg=Umbuygamu
sju=Ume Sami
upi=Umeda
due=Umiray Dumaget Agta
umm=Umon
umo=Umot\u221a\u2260na
ump=Umpila
mtg=Una
unm=Unami
mis=Uncoded languages
unz=Unde Kaili
und=Undetermined
bbn=Uneapa
une=Uneme
uln=Unserdeutsch
onu=Unua
uok=Uokha
cjh=Upper Chehalis
dna=Upper Grand Valley Dani
pov=Upper Guinea Crioulo
dmg=Upper Kinabatangan
kuu=Upper Kuskokwim
tku=Upper Necaxa Totonac
sxu=Upper Saxon
hsb=Upper Sorbian
tth=Upper Ta'oih
tau=Upper Tanana
kgh=Upper Tanudan Kalinga
tov=Upper Taromi
xup=Upper Umpqua
uro=Ura (Papua New Guinea)
uur=Ura (Vanuatu)
urf=Uradhi
urk=Urak Lawoi'
url=Urali
urm=Urapmin
ura=Urarina
xur=Urartian
urt=Urat
ur=Urdu
urd=Urdu
urh=Urhobo
uvh=Uri
urg=Urigina
uri=Urim
urx=Urimo
upv=Uripiv-Wala-Rano-Atchin
urc=Urningangg
ure=Uru
urz=Uru-Eu-Wau-Wau
urp=Uru-Pa-In
urn=Uruangnirin
urv=Uruava
urb=Urub\u221a\u222b-Kaapor
uks=Urub\u221a\u222b-Kaapor Sign Language
ugy=Uruguayan Sign Language
uum=Urum
uru=Urumi
usk=Usaghade
wnu=Usan
usa=Usarufa
ush=Ushojo
cuc=Usila Chinantec
ulf=Usku
usp=Uspanteco
usi=Usui
omo=Utarmbung
ute=Ute-Southern Paiute
utu=Utu
evh=Uvbie
usu=Uya
uz=Uzbek
uzb=Uzbek
auz=Uzbeki Arabic
eze=Uzekwe
vaa=Vaagri Booli
vaf=Vafsi
bij=Vaghat-Ya-Bijim-Legeri
vgr=Vaghri
tva=Vaghua
vag=Vagla
vai=Vai
vap=Vaiphei
vae=Vale
vsv=Valencian Sign Language
cvn=Valle Nacional Chinantec
vmv=Valley Maidu
van=Valman
vlp=Valpei
mkt=Vamale
mlr=Vame
xvn=Vandalic
mpr=Vangunu
vam=Vanimo
vnk=Vano
vau=Vanuma
vao=Vao
vah=Varhadi-Nagpuri
vrs=Varisi
vav=Varli
vas=Vasavi
vaj=Vasekela Bushman
ved=Veddah
val=Vehes
vel=Veluws
vem=Vemgo-Mabas
ve=Venda
ven=Venda
vec=Venetian
xve=Venetic
vsl=Venezuelan Sign Language
bav=Vengo
veo=Venture\u221a\u00b1o
vep=Veps
vra=Vera'a
xvs=Vestinian
vid=Vidunda
vig=Viemo
vi=Vietnamese
vie=Vietnamese
vil=Vilela
vif=Vili
dyg=Villa Viciosa Agta
svc=Vincentian Creole English
vnm=Vinmavis
vin=Vinza
vic=Virgin Islands Creole English
vis=Vishavan
vit=Viti
vto=Vitou
vls=Vlaams
vgt=Vlaamse Gebarentaal
rmy=Vlax Romani
vo=Volap\u221a\u00bak
vol=Volap\u221a\u00bak
xvo=Volscian
kch=Vono
vor=Voro
vot=Votic
vum=Vumbu
vnp=Vunapu
vun=Vunjo
msn=Vur\u221a\u00b4s
vut=Vute
wbi=Vwanji
vro=V\u221a\u00b5ro
wbm=Wa
wag=Wa'ema
wwa=Waama
wmn=Waamwang
ssn=Waata
wab=Wab
wbb=Wabo
kmx=Waboda
wci=Waci Gbe
wdg=Wadaginam
wbq=Waddar
kxp=Wadiyara Koli
wdj=Wadjiginy
wdu=Wadjigu
wrx=Wae Rana
waj=Waffa
wgw=Wagawaga
wga=Wagaya
wbr=Wagdi
waq=Wageman
fad=Wagi
whu=Wahau Kayan
whk=Wahau Kenyah
wgi=Wahgi
wbk=Waigali
wgo=Waigeo
wlk=Wailaki
wlr=Wailapa
rro=Waima
wmh=Waima'a
bao=Waimaha
atr=Waimiri-Atroari
wli=Waioli
waw=Waiwai
wja=Waja
wbv=Wajarri
wav=Waka
wkw=Wakawaka
wkd=Wakde
wbl=Wakhi
waf=Wakon\u221a\u00b0
lgl=Wala
wlw=Walak
wlx=Wali (Ghana)
wll=Wali (Sudan)
wly=Waling
wla=Walio
waa=Walla Walla
wls=Wallisian
wa=Walloon
wln=Walloon
wmt=Walmajarri
dwl=Walo Kumbe Dogon
wae=Walser
ola=Walungge
wmc=Wamas
wmb=Wambaya
wms=Wambon
wme=Wambule
cou=Wamey
wmi=Wamin
wam=Wampanoag
lbq=Wampar
waz=Wampur
wan=Wan
wnb=Wanambre
wnp=Wanap
nnp=Wancho Naga
wbh=Wanda
mfi=Wandala
wad=Wandamen
wnd=Wandarang
wdd=Wandji
wne=Waneci
lwg=Wanga
wyb=Wangaaybuwan-Ngiyambaa
wnm=Wanggamala
wgg=Wangganguru
wng=Wanggom
wbt=Wanman
jub=Wannu
wno=Wano
wnc=Wantoat
wnk=Wanukaka
hwa=Wan\u221a\u00a9
auc=Waorani
juk=Wapan
wap=Wapishana
wao=Wappo
aml=War-Jaintia
wbf=Wara
wba=Warao
wra=Warapu
wrz=Waray (Australia)
war=Waray (Philippines)
srv=Waray Sorsogon
wrr=Wardaman
wrd=Warduji
wsa=Warembori
wai=Wares
wrs=Waris
wbe=Waritai
wri=Wariyangga
wji=Warji
bgv=Warkay-Bipim
wrl=Warlmanpa
wbp=Warlpiri
wrb=Warluwara
wrn=Warnang
wrp=Waropen
wgy=Warrgamay
wwr=Warrwa
wru=Waru
wrm=Warumungu
wrv=Waruna
wrg=Warungu
wss=Wasa
wac=Wasco-Wishram
gsp=Wasembo
was=Washo
wsk=Waskia
wsu=Wasu
wtk=Watakataui
wax=Watam
wah=Watubela
wau=Waur\u221a\u00b0
wuy=Wauyai
www=Wawa
wow=Wawonii
wxa=Waxianghua
oym=Wayampi
way=Wayana
ctt=Wayanad Chetti
wyr=Wayor\u221a\u2265
vay=Wayu
guc=Wayuu
wed=Wedau
weh=Weh
wew=Wejewa
weu=Welaung
klh=Weliki
cy=Welsh
cym=Welsh
rmw=Welsh Romani
wem=Weme Gbe
wei=Were
wer=Weri
kvw=Wersing
nnd=West Ambae
zbw=West Berawan
bbp=West Central Banda
gaz=West Central Oromo
bdr=West Coast Bajau
drn=West Damar
kew=West Kewa
lmj=West Lembata
mqs=West Makian
mss=West Masela
txn=West Tarangan
uve=West Uvean
ybe=West Yugur
lia=West-Central Limba
abe=Western Abnaki
apw=Western Apache
are=Western Arrarnta
bgn=Western Balochi
gnw=Western Bolivian Guaran\u221a\u2260
brv=Western Bru
mbb=Western Bukidnon Manobo
ikt=Western Canadian Inuktitut
cja=Western Cham
dnw=Western Dani
pes=Western Farsi
wyy=Western Fijian
fry=Western Frisian
fy=Western Frisian
gvr=Western Gurung
ctp=Western Highland Chatino
pua=Western Highland Purepecha
nhw=Western Huasteca Nahuatl
jmx=Western Juxtlahuaca Mixtec
knj=Western Kanjobal
kza=Western Karaboro
kuf=Western Katu
kyu=Western Kayah
kjq=Western Keres
krw=Western Krahn
ywl=Western Lalu
lcp=Western Lawa
mrd=Western Magar
mlq=Western Maninkakan
mrj=Western Mari
hmw=Western Mashan Hmong
raf=Western Meohang
mut=Western Muria
amw=Western Neo-Aramaic
fuh=Western Niger Fulfulde
ojw=Western Ojibwa
pnb=Western Panjabi
kjl=Western Parbate Kham
pne=Western Penan
ssl=Western Sisaala
suc=Western Subanon
tdg=Western Tamang
twb=Western Tawbuid
tqt=Western Totonac
tnb=Western Tunebo
mmr=Western Xiangxi Miao
xwl=Western Xwla Gbe
yih=Western Yiddish
wep=Westphalien
wwo=Wetamut
wea=Wewaw
woy=Weyto
giw=White Gelao
lwh=White Lachi
tnp=Whitesands
tua=Wiarumus
wic=Wichita
mzh=Wich\u221a\u2260 Lhamt\u221a\u00a9s G\u221a\u00baisnay
mtp=Wich\u221a\u2260 Lhamt\u221a\u00a9s Nocten
wlv=Wich\u221a\u2260 Lhamt\u221a\u00a9s Vejoz
wie=Wik-Epa
wij=Wik-Iiyanh
wif=Wik-Keyangan
wih=Wik-Me'anha
wim=Wik-Mungkan
wig=Wik-Ngathana
wik=Wikalkan
wua=Wikngenchera
wil=Wilawila
wit=Wintu
kst=Winy\u221a\u00a9
gdr=Wipi
wrh=Wiradhuri
wir=Wiraf\u221a\u00a9d
wiw=Wirangu
wiu=Wiru
wiy=Wiyot
xwc=Woccon
wog=Wogamusin
woc=Wogeo
wbw=Woi
jod=Wojenaka
wle=Wolane
wod=Wolani
wal=Wolaytta
woe=Woleaian
wlo=Wolio
wo=Wolof
wol=Wolof
wom=Wom (Nigeria)
wmo=Wom (Papua New Guinea)
wmx=Womo
won=Wongo
cwd=Woods Cree
wor=Woria
kda=Worimi
jud=Worodougou
unp=Worora
wsv=Wotapuri-Katarqalai
wtw=Wotu
noa=Woun Meu
xwo=Written Oirat
wuu=Wu Chinese
ywq=Wuding-Luquan Yi
wud=Wudu
wlu=Wuliwuli
wux=Wulna
bqm=Wumboko
wum=Wumbvu
ywu=Wumeng Nasu
bwn=Wunai Bunu
wub=Wunambal
wur=Wurrugu
yig=Wusa Nasu
bse=Wushi
wsi=Wusi
wut=Wutung
wuh=Wutunhua
wuv=Wuvulu-Aua
udl=Wuzlam
wya=Wyandot
wym=Wymysorys
tci=W\u221a\u00b0ra
juw=W\u221a\u00a3pha
wob=W\u221a\u00ae Northern
gxx=W\u221a\u00ae Southern
wec=W\u221a\u00ae Western
kao=Xaasongaxango
zax=Xadani Zapotec
xkr=Xakriab\u221a\u00b0
xan=Xamtanga
ztg=Xanagu\u221a\u2260a Zapotec
axx=Xaragure
xav=Xav\u221a\u00b0nte
xer=Xer\u221a\u00a9nte
xet=Xet\u221a\u00b0
xh=Xhosa
xho=Xhosa
xia=Xiandao
hsn=Xiang Chinese
sjo=Xibe
too=Xicotepec De Ju\u221a\u00b0rez Totonac
xin=Xinca
asn=Xing\u221a\u222b Asurin\u221a\u2260
xiy=Xipaya
xip=Xipin\u221a\u00b0wa
xii=Xiri
xir=Xiri\u221a\u00a2na
ywt=Xishanba Lalo
xok=Xokleng
xoo=Xukur\u221a\u222b
xwe=Xwela Gbe
ane=X\u221a\u00a2r\u221a\u00a2c\u221a\u03c0\u221a\u03c0
muu=Yaaku
yar=Yabarana
ybn=Yaba\u221a\u00a2na
jae=Yabem
ybm=Yaben
ybo=Yabong
ekr=Yace
rys=Yaeyama
wfg=Yafi
ygr=Yagaria
yai=Yagnobi
ygm=Yagomi
yad=Yagua
ygw=Yagwoia
ner=Yahadian
rhp=Yahang
ynu=Yahuna
axk=Yaka (Central African Republic)
iyx=Yaka (Congo)
yaf=Yaka (Democratic Republic of Congo)
ykk=Yakaikeke
yka=Yakan
ybh=Yakha
yak=Yakima
yky=Yakoma
sah=Yakut
yba=Yala
jal=Yalahatan
xyl=Yalakalore
ylr=Yalarnnga
nce=Yale
yal=Yalunka
zpu=Yal\u221a\u00b0lag Zapotec
ymp=Yamap
yam=Yamba
ymb=Yambes
yat=Yambeta
jmd=Yamdena
yme=Yameo
tao=Yami
yaa=Yaminahua
ymn=Yamna
ymg=Yamongeri
yma=Yamphe
ybi=Yamphu
jay=Yan-nhangu
ynn=Yana
qur=Yanahuanca Pasco Quechua
dym=Yanda Dom Dogon
ynd=Yandruwandha
ame=Yanesha'
zyg=Yang Zhuang
yav=Yangben
ybd=Yangbye
ynh=Yangho
bsx=Yangkam
jng=Yangman
yng=Yango
ynl=Yangulam
yde=Yangum Dey
ygl=Yangum Gel
ymo=Yangum Mon
kdd=Yankunytjatjara
guu=Yanomam\u221a\u2202
wca=Yanom\u221a\u00b0mi
yns=Yansi
jao=Yanyuwa
yao=Yao
asy=Yaosakor Asmat
yre=Yaour\u221a\u00a9
yap=Yapese
yev=Yapunda
jaq=Yaqay
yaq=Yaqui
yrw=Yarawata
yrb=Yareba
zae=Yareni Zapotec
yrs=Yarsun
yri=Yar\u221a\u2260
yko=Yasa
ysc=Yassic
zty=Yatee Zapotec
zav=Yatzachi Zapotec
yuw=Yau (Morobe Province)
yyu=Yau (Sandaun Province)
yla=Yaul
yax=Yauma
jau=Yaur
zpb=Yautepec Zapotec
qux=Yauyos Quechua
yvt=Yavitero
yva=Yawa
yaw=Yawalapit\u221a\u2260
ywn=Yawanawa
yww=Yawarawarga
yby=Yaweyuha
ybx=Yawiyo
ywr=Yawuru
yah=Yazgulyam
tlc=Yecuatla Totonac
jei=Yei
ets=Yekhee
ykr=Yekora
yel=Yela
yle=Yele
jel=Yelmek
ylg=Yelogu
ybb=Yemba
jnj=Yemsa
yen=Yendang
yei=Yeni
yec=Yeniche
yra=Yerakai
gop=Yeretuar
yrn=Yerong
yeu=Yerukula
yes=Yeskwa
yss=Yessan-Mayo
yet=Yetfa
yej=Yevanic
yey=Yeyi
yi=Yiddish
yid=Yiddish
yds=Yiddish Sign Language
ydg=Yidgha
yii=Yidiny
yll=Yil
yee=Yimas
yim=Yimchungru Naga
kvu=Yinbaw Karen
yin=Yinchia
yij=Yindjibarndi
yil=Yindjilandji
pib=Yine
yia=Yinggarda
kvy=Yintale Karen
yiy=Yir Yoront
yis=Yis
gek=Yiwom
yob=Yoba
gud=Yocobou\u221a\u00a9 Dida
yog=Yogad
ydk=Yoidik
yki=Yoke
yok=Yokuts
yol=Yola
xty=Yoloxochitl Mixtec
pil=Yom
yom=Yombe
yoi=Yonaguni
yno=Yong
zyb=Yongbei Zhuang
yon=Yonggom
zyn=Yongnan Zhuang
yut=Yopno
mts=Yora
yox=Yoron
yo=Yoruba
yor=Yoruba
yos=Yos
mpm=Yosond\u221a\u222ba Mixtec
zyj=Youjiang Zhuang
jiu=Youle Jinuo
buh=Younuo Bunu
yoy=Yoy
nua=Yuaga
msd=Yucatec Maya Sign Language
yua=Yucateco
yuc=Yuchi
mvg=Yucua\u221a\u00b1e Mixtec
ycn=Yucuna
yue=Yue Chinese
yug=Yug
yub=Yugambal
yuu=Yugh
ysl=Yugoslavian Sign Language
yab=Yuhup
yuk=Yuki
yup=Yukpa
ybl=Yukuben
yul=Yulu
yuq=Yuqui
yuz=Yuracare
yur=Yurok
yui=Yurut\u221a\u2260
mab=Yutanduchi Mixtec
yau=Yuwana
yag=Y\u221a\u00b0mana
ztx=Zaachila Zapotec
kji=Zabana
ctz=Zacatepec Chatino
nhi=Zacatl\u221a\u00b0n-Ahuacatl\u221a\u00b0n-Tepetzintla Nahuatl
zag=Zaghawa
atb=Zaiwa
zkr=Zakhring
zsl=Zambian Sign Language
zna=Zan Gula
zak=Zanaki
zne=Zande (individual language)
zau=Zangskari
zah=Zangwal
zpw=Zaniza Zapotec
zap=Zapotec
zaj=Zaramo
zaz=Zari
dje=Zarma
zrp=Zarphatic
zal=Zauzou
zwa=Zay
kxk=Zayein Karen
zay=Zayse-Zergulla
zza=Zaza
jaj=Zazao
zua=Zeem
zea=Zeeuws
dhm=Zemba
nzm=Zeme Naga
xzm=Zemgalian
zeg=Zenag
zen=Zenaga
czn=Zenzontepec Chatino
zhb=Zhaba
xzh=Zhang-Zhung
zhi=Zhire
zhw=Zhoa
za=Zhuang
zha=Zhuang
zia=Zia
ziw=Zigula
zik=Zimakani
zmb=Zimba
zib=Zimbabwe Sign Language
zin=Zinza
sih=Zire
zrn=Zirenkel
zir=Ziriya
ziz=Zizilivakan
pto=Zo'\u221a\u00a9
yzk=Zokhuo
zpq=Zoogocho Zapotec
gbz=Zoroastrian Dari
czt=Zotung Chin
zom=Zou
gnd=Zulgo-Gemzek
zu=Zulu
zul=Zulu
zuy=Zumaya
jmb=Zumbun
zun=Zuni
zzj=Zuojiang Zhuang
zyp=Zyphe
zro=Z\u221a\u00b0paro
ahn=\u221a\u00c4h\u221a\u2020n
acb=\u221a\u00c5nc\u221a\u00b0
aom=\u221a\u00f1mie
oon=\u221a\u00f1nge
